#lemma	stem
nastawk	nastawk
kapitl	kapitl
markěrowanje	markěrowanj
předłoha	předłoh
biologija	biologij
wobłuk	wobłuk
swět	swět
wědomosć	wědomosć
biochemija	biochemij
genetika	genetik
fyziologija	fyziologij
anatomija	anatomij
etologija	etologij
ekologija	ekologij
systematika	systematik
botanika	botanik
coologija	coologij
mykologija	mykologij
mikrobiologija	mikrobiologij
morfologija	morfologij
bionika	bionik
disciplina	disciplin
wirologija	wirologij
specializowany	specializowan
ćěleso	ćěles
prućik	prućik
struktura	struktur
mikrotubulij	mikrotubulij
zakótwjenje	zakótwjenj
cytoskelet	cytoskelet
mitoza	mitoz
čas	čas
dźělenje	dźělenj
bańka	bańk
fragmoplast	fragmoplast
pyrenoid	pyrenoid
hrib	hrib
wottwar	wottwar
rostlina	rostlin
symbioz	symbioz
mykorica	mykoric
parazit	parazit
kónčina	kónčin
mjez	mjez
horina	horin
golf	golf
pusćina	pusćin
region	region
kónc	kónc
mócnarstwo	mócnarstw
zapřijeće	zapřijeć
epocha	epoch
wutwor	wutwor
mjeno	mjen
institut	institut
rěč	rěč
stawizna	stawizn
kultura	kultur
zašłosć	zašłosć
přitomnosć	přitomnosć
materialija	materialij
slědźenje	slědźenj
zjawnosć	zjawnosć
połoženje	połoženj
wosebitosć	wosebitosć
přirunowanje	přirunowanj
sobudźěłaćer	sobudźěłaćer
praksa	praks
móžnosć	móžnosć
sydło	sydł
wotnožka	wotnožk
januar	januar
stat	stat
kraj	kraj
forma	form
towarstwo	towarstw
tradicija	tradicij
slědźenišćo	slědźenišć
ludospyt	ludospyt
lěto	lět
akademija	akademij
zarjadnišće	zarjadnišć
wukraj	wukraj
fachowc	fachowc
nadawk	nadawk
uniwersita	uniwersit
šula	šul
kurs	kurs
woda	wod
oksid	oksid
atom	atom
protium	protium
symbol	symbol
izotop	izotop
deuterium	deuterium
tritium	tritium
cycak	cycak
podklasa	podklas
porjad	porjad
strona	stron
měchawc	měchawc
raz	raz
skupina	skupin
swójba	swójb
město	měst
doba	dob
symjenjo	symjenj
dźeń	dźeń
archiw	archiw
sobota	sobot
měrc	měrc
hodźina	hodźin
premjera	premjer
zwjazk	zwjazk
spis	spis
kniharnja	kniharnj
zaměr	zaměr
słowoskład	słowoskład
słowo	słow
funkcija	funkcij
wužiwar	wužiwar
jednota	jednot
moc	moc
palast	palast
kral	kral
reprezentacija	reprezentacij
lugal	lugal
čłowjek	čłowjek
narok	narok
knježićel	knježićel
row	row
družbina	družbin
projekt	projekt
wustup	wustup
adresa	adres
wotrězk	wotrězk
mjezota	mjezot
družina	družin
cest	cest
werb	werb
substantiw	substantiw
reja	rej
adjektiw	adjektiw
adwerb	adwerb
hamor	hamor
rjemjesło	rjemjesł
wikowanje	wikowanj
wuznam	wuznam
sydlišće	sydlišć
spad	spad
smjerć	smjerć
wójsko	wójsk
lětoličba	lětoličb
centrum	centrum
pomjatk	pomjatk
generacija	generacij
přičina	přičin
lud	lud
wuchod	wuchod
lětstotk	lětstotk
znamjenje	znamjenj
zastupjer	zastupjer
takson	takson
charofyta	charofyt
chloroplastida	chloroplastid
chloroplast	chloroplast
chlorophyll	chlorophyll
pigment	pigment
karotinoid	karotinoid
škrob	škrob
polysaccharid	polysaccharid
sćěna	sćěn
celuloza	celuloz
sporopolenin	sporopolenin
sporofyt	sporofyt
kutikula	kutikul
wjazba	wjazb
žiwoch	žiwoch
zemja	zemj
wuměnjenje	wuměnjenj
temperatura	temperatur
dypk	dypk
maćizna	maćizn
lód	lód
para	par
zarjadnistwo	zarjadnistw
wudawanje	wudawanj
wukaz	wukaz
kodeks	kodeks
rozpad	rozpad
zańdźenje	zańdźenj
šansa	šans
postup	postup
lisćina	lisćin
nacionalsocializm	nacionalsocializm
nationalsozialismus	nationalsozialismus
nacizm	nacizm
ideologija	ideologij
swětonahlad	swětonahlad
republika	republik
wójna	wójn
złóstnistwo	złóstnistw
reich	reich
přikład	přikład
holocaust	holocaust
kajkosć	kajkosć
faza	faz
geometrija	geometrij
powjerch	powjerch
organizm	organizm
wumjenje	wumjenj
miliarda	miliard
wobydler	wobydler
wobydlerstwo	wobydlerstw
proces	proces
pad	pad
změna	změn
system	system
knjejstwo	knjejstw
rozpjeće	rozpjeć
přeměnjenje	přeměnjenj
titl	titl
kubl	kubl
konferenca	konferenc
referent	referent
referentka	referentk
hospodarstwo	hospodarstw
ablawt	ablawt
wokal	wokal
dołhosć	dołhosć
pomjenowanje	pomjenowanj
schodźenk	schodźenk
njedostatk	njedostatk
parameter	parameter
podrobnosć	podrobnosć
dokumentacija	dokumentacij
zelo	zel
słoma	słom
bělkowina	bělkowin
žratwa	žratw
junij	junij
awgust	awgust
dźiwadźelnica	dźiwadźelnic
spěwarka	spěwark
model	model
sex	sex
rjad	rjad
přesunjenje	přesunjenj
wobraz	wobraz
čoło	čoł
bóh	bóh
kupnica	kupnic
móc	móc
puć	puć
přitok	přitok
morjo	morj
wobstaće	wobstać
zběžk	zběžk
tworjenje	tworjenj
preteritum	preteritum
eksonym	eksonym
objekt	objekt
rěka	rěk
hora	hor
krajina	krajin
zběrka	zběrk
wupisk	wupisk
wučbnica	wučbnic
geografija	geografij
lětnik	lětnik
słownik	słownik
leksika	leksik
naprašowanje	naprašowanj
kooperacija	kooperacij
symjenišćo	symjenišć
płódnik	płódnik
płod	płod
dźěl	dźěl
kćenje	kćenj
diftong	diftong
sćěh	sćěh
połojca	połojc
lěttysac	lěttysac
nopa	nop
dom	dom
wěstota	wěstot
poměr	poměr
namakanka	namakank
figurina	figurin
obsidian	obsidian
mnóstwo	mnóstw
brjenka	brjenk
dopokaz	dopokaz
kislik	kislik
płun	płun
element	element
ocon	ocon
spočatk	spočatk
njewotwisnosć	njewotwisnosć
róla	ról
běh	běh
přewinjenje	přewinjenj
dualizm	dualizm
institucija	institucij
wid	wid
hodownik	hodownik
měsac	měsac
swjedźeń	swjedźeń
hody	hod
patoržica	patoržic
december	december
silwester	silwester
teritorij	teritorij
žiwjenje	žiwjenj
disponujomnosć	disponujomnosć
wažnosć	wažnosć
mapa	map
barba	barb
metr	metr
zastaranje	zastaranj
hranica	hranic
konflikt	konflikt
srědk	srědk
stolica	stolic
gametofyt	gametofyt
organ	organ
anteridija	anteridij
archegonija	archegonij
krytosymjenjak	krytosymjenjak
přednošk	přednošk
wurjekowanje	wurjekowanj
kralestwo	kralestw
juhowuchod	juhowuchod
milion	milion
aglomeracija	aglomeracij
wotkaz	wotkaz
tematika	tematik
licenca	licenc
awtor	awtor
edit	edit
překupc	překupc
dynastija	dynastij
zamóženje	zamóženj
wobchod	wobchod
wočakowanje	wočakowanj
zdaće	zdać
wiki	wiki
bazar	bazar
dokument	dokument
biblioteka	bibliotek
zarjadnišćo	zarjadnišć
wobstaranje	wobstaranj
zadźěłanje	zadźěłanj
archiwizowanje	archiwizowanj
spřistupnjenje	spřistupnjenj
literatura	literatur
wozjewjenje	wozjewjenj
wotrjad	wotrjad
předewzaće	předewzać
wužiwanje	wužiwanj
zapis	zapis
kniha	knih
přizjewjenje	přizjewjenj
knihownja	knihownj
wobstatk	wobstatk
čitarnja	čitarnj
instutut	instutut
rumnosć	rumnosć
wupožčenje	wupožčenj
postajenje	postajenj
zasada	zasad
njedźela	njedźel
nowiny	nowin
medija	medij
žórło	žórł
wotběh	wotběh
podlěšenje	podlěšenj
překročenje	překročenj
wupožčer	wupožčer
napominanje	napominanj
wuspěch	wuspěch
žadanje	žadanj
wobmjezowanje	wobmjezowanj
časopis	časopis
dispozicija	dispozicij
periodikum	periodikum
lětopis	lětopis
wuwzaće	wuwzać
eksemplar	eksemplar
drohoćinka	drohoćink
nawod	nawod
našmórnjenje	našmórnjenj
škoda	škod
zhubjenje	zhubjenj
bibliografija	bibliografij
kopěrak	kopěrak
prawo	praw
zamołwitosć	zamołwitosć
zranjenje	zranjenj
kopija	kopij
pomoc	pomoc
scanner	scanner
reprodukcija	reprodukcij
požćonk	požćonk
požčonk	požčonk
wotrjadnik	wotrjadnik
kolega	koleg
posłužba	posłužb
popłatk	popłatk
płaćiwosć	płaćiwosć
pismo	pism
zwuk	zwuk
sada	sad
narod	narod
epos	epos
sumerišćina	sumerišćin
akkadšćina	akkadšćin
zasydlowanje	zasydlowanj
rozšěrjowanje	rozšěrjowanj
kmjen	kmjen
měsačk	měsačk
aramejšćina	aramejšćin
jubilej	jubilej
słowjanski	słowjanski
kontakt	kontakt
klik	klik
wopisanje	wopisanj
formalnosć	formalnosć
nowy	now
wikipedija	wikipedij
dźěło	dźěł
encyklopedija	encyklopedij
knježerstwo	knježerstw
sejm	sejm
monarch	monarch
załožk	załožk
templ	templ
srjedźišćo	srjedźišć
hórka	hórk
přechad	přechad
zdźěla	zdźěl
embryo	embry
stadij	stadij
znamješko	znamješk
pisak	pisak
tafla	tafl
linija	linij
kašćik	kašćik
kónčk	kónčk
kusk	kusk
dokonjanosć	dokonjanosć
starowysokoněmske	starowysokoněmsk
pochad	pochad
fakt	fakt
rozměr	rozměr
wino	win
dótknjenje	dótknjenj
štwórćina	štwórćin
kopica	kopic
ocean	ocean
cirkulacija	cirkulacij
powětr	powětr
wjedro	wjedr
nahlad	nahlad
alga	alg
studija	studij
propagacija	propagacij
silikat	silikat
mezopotamiska	mezopotamisk
zmysl	zmysl
runina	runin
technologija	technologij
powodźenje	powodźenj
polo	pol
wjerch	wjerch
kotryž	kotryž
ruka	ruk
kanalizowanje	kanalizowanj
rólnistwo	rólnistw
etat	etat
organizacija	organizacij
aparat	aparat
njewólnik	njewólnik
naturalija	naturalij
swójstwo	swójstw
najenk	najenk
wukon	wukon
slěbro	slěbr
dataja	dataj
šlešćina	šlešćin
dialekt	dialekt
linguistik	linguistik
ratar	ratar
produkt	produkt
žiwidło	žiwidł
tekstilija	tekstilij
měšnik	měšnik
wliw	wliw
tribut	tribut
dawk	dawk
ležownosć	ležownosć
wobsydstwo	wobsydstw
lěpšina	lěpšin
póda	pód
zelenina	zelenin
łočica	łočic
pěst	pěst
pěstk	pěstk
internet	internet
ministerstwo	ministerstw
wóska	wósk
ekliptika	ekliptik
nuhel	nuhel
fenomen	fenomen
počas	počas
perioda	period
klimat	klimat
hódnota	hódnot
rytmus	rytmus
nalěćo	nalěć
dohlad	dohlad
rozdźěl	rozdźěl
zarjadowanje	zarjadowanj
inteligenca	inteligenc
termin	termin
póndźela	póndźel
tema	tem
diskusija	diskusij
zajimc	zajimc
durje	durj
wopytowar	wopytowar
rozprawa	rozpraw
swojoraznosć	swojoraznosć
serbšćina	serbšćin
čěšćina	čěšćin
pólšćina	pólšćin
słowakšćina	słowakšćin
wuraz	wuraz
situacija	situacij
idiom	idiom
režiser	režiser
widejoklip	widejoklip
recitacija	recitacij
baseń	baseń
nahrawanje	nahrawanj
woznamjenjenje	woznamjenjenj
zjeće	zjeć
kontinent	kontinent
definicija	definicij
plata	plat
masa	mas
nastupanje	nastupanj
kupa	kup
přestrjeń	přestrjeń
kilometer	kilometer
redakcija	redakcij
ćišć	ćišć
bibliotekar	bibliotekar
slawist	slawist
nakładnistwo	nakładnistw
publikacija	publikacij
poćah	poćah
rum	rum
wosobina	wosobin
přiroda	přirod
brošurka	brošurk
přinošk	přinošk
zběrnik	zběrnik
tydźenik	tydźenik
dźenik	dźenik
recensija	recensij
wersija	wersij
přistup	přistup
wobsah	wobsah
wuběrk	wuběrk
wobnowjer	wobnowjer
oktober	oktober
klasikar	klasikar
sorabistika	sorabistik
hladanje	hladanj
ćišinski	ćišinski
předstajenje	předstajenj
wujasnjenje	wujasnjenj
moderna	modern
fundus	fundus
přepytownje	přepytownj
interpretacija	interpretacij
cyłk	cyłk
rysowanka	rysowank
moler	moler
mišter	mišter
stoł	stoł
format	format
administrator	administrator
zastupnik	zastupnik
serwer	serwer
škit	škit
dobro	dobr
tekst	tekst
molekul	molekul
teorija	teorij
typ	typ
wodźik	wodźik
por	por
elektron	elektron
róžk	róžk
tetraedr	tetraedr
potrjeba	potrjeb
elekron	elekron
pikometer	pikometer
prezident	prezident
pozicija	pozicij
srjeda	srjed
předsudk	předsudk
stereotyp	stereotyp
doktorandka	doktorandk
insitut	insitut
wuslědk	wuslědk
disertacija	disertacij
započatk	započatk
alfabet	alfabet
rěčnik	rěčnik
pismik	pismik
gramatikar	gramatikar
sanskrit	sanskrit
stopjeń	stopjeń
podlěšenski	podlěšenski
róst	róst
korjeń	korjeń
hesło	hesł
połwokal	połwokal
likwid	likwid
nazal	nazal
subkontinent	subkontinent
monsun	monsun
mej	mej
přibrjoh	přibrjoh
juhozapad	juhozapad
połkupa	połkup
směr	směr
němčina	němčin
wokołk	wokołk
morchwja	morchwj
sewjerozapad	sewjerozapad
sewjer	sewjer
zapad	zapad
pobrjóh	pobrjóh
pokrok	pokrok
bydlišćo	bydlišć
zbytk	zbytk
silo	sil
činitosć	činitosć
stil	stil
podobnosć	podobnosć
kult	kult
dokład	dokład
keramika	keramik
motiw	motiw
technika	technik
hlina	hlin
tačel	tačel
muka	muk
přidawk	přidawk
chlěbpječenje	chlěbpječenj
substanca	substanc
rozpušćadło	rozpušćadł
napjatosć	napjatosć
hustosć	hustosć
atmosfera	atmosfer
absorbowadło	absorbowadł
promjenjenje	promjenjenj
ćopłota	ćopłot
klima	klim
antologija	antologij
krótkopowědančko	krótkopowědančk
złoto	złot
zak	zak
sewjerowuchod	sewjerowuchod
nižina	nižin
kromja	kromj
wotwalenje	wotwalenj
september	september
dešć	dešć
mróčel	mróčel
chronologija	chronologij
eponym	eponym
chronika	chronik
synchronizm	synchronizm
podawk	podawk
referenca	referenc
myt	myt
protyka	protyk
přir	přir
kalender	kalender
ličenje	ličenj
citat	citat
dobywanje	dobywanj
rozmach	rozmach
boh	boh
zemjedźěl	zemjedźěl
federacija	federacij
kategorija	kategorij
zarodk	zarodk
městnosć	městnosć
žito	žit
hałza	hałz
zhotowjenje	zhotowjenj
smoła	smoł
kołmaz	kołmaz
namjet	namjet
biografija	biografij
achejmenid	achejmenid
proklamacija	proklamacij
cylinder	cylinder
wjednik	wjednik
sel	sel
cokor	cokor
skutkowanje	skutkowanj
matabolizm	matabolizm
wolij	wolij
membrana	membran
wěc	wěc
architektura	architektur
namrěwstwo	namrěwstw
přełožk	přełožk
tydźeń	tydźeń
assyričan	assyričan
detail	detail
kamuška	kamušk
wuwiće	wuwić
słužba	słužb
pisar	pisar
wosoba	wosob
towaršnosć	towaršnosć
wjednistwo	wjednistw
nacionalsocialist	nacionalsocialist
diktatura	diktatur
přećiwnik	přećiwnik
politika	politik
předmjet	předmjet
metoda	metod
rozrjadowanje	rozrjadowanj
nastaće	nastać
woznam	woznam
huba	hub
chlěb	chlěb
prašenje	prašenj
korčmja	korčmj
bjesada	bjesad
směrnica	směrnic
prawidło	prawidł
pokiw	pokiw
princ	princ
spjećowanje	spjećowanj
twarjenje	twarjenj
kanal	kanal
cyrkej	cyrkej
zahroda	zahrod
rostlinarnja	rostlinarnj
napismo	napism
wobhladowak	wobhladowak
karta	kart
stupjenje	stupjenj
babylon	babylon
wobkedźbowanje	wobkedźbowanj
zaćmiće	zaćmić
wjetšina	wjetšin
juh	juh
syć	syć
zwjazanje	zwjazanj
cil	cil
ličak	ličak
wuměna	wuměn
protokol	protokol
brjóh	brjóh
předměsto	předměst
přewrót	přewrót
grjekšćina	grjekšćin
łaćonšćina	łaćonšćin
srjedźowěk	srjedźowěk
konsonant	konsonant
prapismo	prapism
papyrus	papyrus
pergament	pergament
wikisłownik	wikisłownik
rozpušćomnosć	rozpušćomnosć
pohódnoćenje	pohódnoćenj
wulkosć	wulkosć
nastajenje	nastajenj
měnjenje	měnjenj
symjeńc	symjeńc
debata	debat
wašnje	wašnj
ryba	ryb
rjapnik	rjapnik
kladistika	kladistik
pazork	pazork
łopjeno	łopjen
zawiječk	zawiječk
šěrokosć	šěrokosć
wobrazk	wobrazk
piksel	piksel
wysokosć	wysokosć
proporcija	proporcij
bok	bok
japanšćina	japanšćin
chinšćina	chinšćin
francošćina	francošćin
jendźelšćina	jendźelšćin
hindišćina	hindišćin
šwedšćina	šwedšćin
italšćina	italšćin
španšćina	španšćin
napoj	napoj
droždźe	droždź
brěčka	brěčk
jahoda	jahod
pakić	pakić
prut	prut
winowc	winowc
šmica	šmic
hybrid	hybrid
připućowanje	připućowanj
wuprawa	wupraw
gutejčan	gutejčan
cikurat	cikurat
čitanje	čitanj
mišterstwo	mišterstw
kopańca	kopańc
samotar	samotar
wjelk	wjelk
wuměłc	wuměłc
přełožowar	přełožowar
rěčka	rěčk
niwow	niwow
jězor	jězor
hudźba	hudźb
kamera	kamer
orbit	orbit
planet	planet
słónco	słónc
tři	tři
kić	kić
rozpor	rozpor
hammurabi	hammurabi
zakoń	zakoń
paragraf	paragraf
aspekt	aspekt
rozsudźenje	rozsudźenj
krutosć	krutosć
historikar	historikar
spisowaćel	spisowaćel
španišćina	španišćin
kastilšćina	kastilšćin
pućowanje	pućowanj
přećelstwo	přećelstw
wokruh	wokruh
wusyłanje	wusyłanj
podkast	podkast
center	center
wobwod	wobwod
zwisk	zwisk
susod	susod
oxygen	oxygen
kisilina	kisilin
apofonija	apofonij
morf	morf
morphem	morphem
rěčewěda	rěčewěd
poznamjenjenje	poznamjenjenj
fleksija	fleksij
prarěč	prarěč
wuskutk	wuskutk
dalokowikowanje	dalokowikowanj
delta	delt
twora	twor
lódź	lódź
karawana	karawan
wosoł	wosoł
wjelbłud	wjelbłud
měra	měr
kóń	kóń
wóz	wóz
dróha	dróh
baza	baz
diferenca	diferenc
efekt	efekt
narunanje	narunanj
reakcija	reakcij
ćěłoškódny	ćěłoškódn
ćěło	ćěł
wustajeńca	wustajeńc
muzej	muzej
opcija	opcij
rezultat	rezultat
wobjim	wobjim
dychanje	dychanj
jednobańkowc	jednobańkowc
smažnik	smažnik
rewolucionar	rewolucionar
rozpačenje	rozpačenj
swětło	swětł
fotosynteza	fotosyntez
genus	genus
numerus	numerus
pronomen	pronomen
namakanki	namakanki
koleso	koles
monokotyledon	monokotyledon
eudikotyledon	eudikotyledon
přiwuznosć	přiwuznosć
kladogram	kladogram
moch	moch
zańdźenosć	zańdźenosć
přiwuznistwo	přiwuznistw
wotrys	wotrys
serb	serb
wyšnosć	wyšnosć
rozswětlerstwo	rozswětlerstw
romantika	romantik
wozrodźenje	wozrodźenj
wědomje	wědomj
fenylpropanoid	fenylpropanoid
terpen	terpen
idioblast	idioblast
łopješko	łopješk
přirjadowanje	přirjadowanj
kružk	kružk
próšk	próšk
bencylisochinolinalkaloid	bencylisochinolinalkaloid
neolignan	neolignan
kapka	kapk
škleńca	škleńc
transpiracija	transpiracij
germanšćina	germanšćin
grupa	grup
particip	particip
karotin	karotin
cona	con
wjes	wjes
gmejna	gmejn
zjednoćenstwo	zjednoćenstw
wokrjes	wokrjes
wjeska	wjesk
wobsydlenje	wobsydlenj
ratarstwo	ratarstw
cyhel	cyhel
piktogram	piktogram
spóznaće	spóznać
podswójba	podswójb
nomad	nomad
bakterija	bakterij
mikroorganizm	mikroorganizm
wutk	wutk
koordinacija	koordinacij
krok	krok
wuwiwanje	wuwiwanj
knihiwjedstwo	knihiwjedstw
rjek	rjek
čłowjestwo	čłowjestw
prowinca	prowinc
starowěk	starowěk
unija	unij
zastupjerka	zastupjerk
hibanje	hibanj
internacionalistka	internacionalistk
předsydka	předsydk
jednotka	jednotk
přibrjóh	přibrjóh
dno	dn
smuha	smuh
kruh	kruh
wichor	wichor
mróz	mróz
pěsk	pěsk
praworóžk	praworóžk
thumb	thumb
zrěčenje	zrěčenj
protektorat	protektorat
eukaryot	eukaryot
embryofyt	embryofyt
poražka	poražk
wadźeńca	wadźeńc
žadosć	žadosć
wjeršk	wjeršk
politikar	politikar
čisło	čisł
klasa	klas
deklinacija	deklinacij
kamjeń	kamjeń
łušćina	łušćin
hydrat	hydrat
wopřijeće	wopřijeć
serwjernogermanšćina	serwjernogermanšćin
přezwuk	přezwuk
złóžka	złóžk
zjaw	zjaw
punkt	punkt
interwencja	interwencj
nocleg	nocleg
ofiara	ofiar
przemoc	przemoc
budynek	budynek
parafia	parafi
remont	remont
placówka	placówk
dotacja	dotacj
głosowanie	głosowani
wniosek	wniosek
radny	radn
udostępnienie	udostępnieni
film	film
nagranie	nagrani
sprawa	spraw
końcówka	końcówk
sesja	sesj
okres	okres
roztargnienie	roztargnieni
zapominanie	zapominani
tydzień	tydzień
zaduma	zadum
refleksja	refleksj
zawód	zawód
brat	brat
komisja	komisj
poborowa	poborow
szwagier	szwagier
teściowa	teściow
kolczyk	kolczyk
relacja	relacj
otwarcie	otwarci
ośrodek	ośrodek
numer	numer
podstawa	podstaw
tradycja	tradycj
praktyka	praktyk
pogaństwo	pogaństw
oko	ok
nadużycie	nadużyci
ksiądz	ksiądz
podwyżka	podwyżk
przemysł	przemysł
zamiennik	zamiennik
lek	lek
skutek	skutek
chemioterapia	chemioterapi
miesiąc	miesiąc
walka	walk
hotel	hotel
miłośnik	miłośnik
pięściarstwo	pięściarstw
pojedynek	pojedynek
wiewiórka	wiewiórk
bielizna	bielizn
lady	lad
koniec	koniec
odkrycie	odkryci
naukowiec	naukowiec
stosowanie	stosowani
mikstura	mikstur
ekipa	ekip
profesor	profesor
instytut	instytut
mieszanka	mieszank
zmiana	zmian
płeć	płeć
konieczność	konieczność
sukces	sukces
operacja	operacj
adaptacja	adaptacj
eksplorator	eksplorator
odkrywca	odkrywc
świat	świat
większość	większość
mieszkaniec	mieszkaniec
szczerość	szczerość
upływ	upływ
ultimatum	ultimatum
siła	sił
działanie	działani
kłopot	kłopot
kieszeń	kieszeń
fartuch	fartuch
kluczyk	kluczyk
kredens	kredens
dwór	dwór
rodzaj	rodzaj
apteczka	apteczk
całość	całość
notatka	notatk
aneks	aneks
piętro	piętr
tempo	temp
zwiedzanie	zwiedzani
zmierzch	zmierzch
człowiek	człowiek
głowa	głow
porucznik	porucznik
czwartak	czwartak
artyleria	artyleri
szosa	szos
pole	pol
wojsko	wojsk
ładunek	ładunek
odpowiedź	odpowiedź
skarb	skarb
ziemia	ziemi
książka	książk
historia	histori
temat	temat
przeszłość	przeszłość
chłopak	chłopak
lekarz	lekarz
wystawa	wystaw
portret	portret
burta	burt
statek	statek
imperatorowa	imperatorow
postać	postać
brzeg	brzeg
ptak	ptak
wyjście	wyjści
taras	taras
stół	stół
prawda	prawd
siostra	siostr
związek	związek
mama	mam
godzina	godzin
telefon	telefon
zakład	zakład
epizod	epizod
powrót	powrót
widok	widok
wał	wał
most	most
odstęp	odstęp
czas	czas
przykrość	przykrość
próba	prób
podziękowanie	podziękowani
życzenia	życzeni
rok	rok
wypadek	wypadek
władza	władz
mężczyzna	mężczyzn
samochód	samochód
baba	bab
histeria	histeri
jarmark	jarmark
pokolenie	pokoleni
ślad	ślad
sad	sad
ojciec	ojciec
majątek	majątek
rodzic	rodzic
głos	głos
naciśnięcie	naciśnięci
przycisk	przycisk
obecność	obecność
charakter	charakter
zgłoszenie	zgłoszeni
poparcie	poparci
propozycja	propozycj
gospodarka	gospodark
część	część
pegeer	pegeer
cel	cel
powiększenie	powiększeni
gospodarstwo	gospodarstw
rolnik	rolnik
państwo	państw
przyjęcie	przyjęci
uchwała	uchwał
ustawa	ustaw
wynik	wynik
senat	senat
organizowanie	organizowani
prowadzenie	prowadzeni
działalność	działalność
pan	pan
właściwość	właściwość
instytucja	instytucj
przekonanie	przekonani
praca	prac
droga	drog
następca	następc
ojczyzna	ojczyzn
porządek	porządek
rzecz	rzecz
składanie	składani
trakt	trakt
obrady	obrad
poprawka	poprawk
protest	protest
pani	pani
marszałek	marszałek
nowelizacja	nowelizacj
wybór	wybór
prezydent	prezydent
pytanie	pytani
dostosowanie	dostosowani
koncepcja	koncepcj
odmiana	odmian
kategoria	kategori
roślina	roślin
senator	senator
podanie	podani
sprawozdawca	sprawozdawc
akceptacja	akceptacj
decyzja	decyzj
izba	izb
moment	moment
sprawozdanie	sprawozdani
druk	druk
problem	problem
odrzucenie	odrzuceni
zakończenie	zakończeni
wystąpienie	wystąpieni
przyjmowanie	przyjmowani
uwaga	uwag
biuro	biur
opinia	opini
przeprowadzenie	przeprowadzeni
wydanie	wydani
miliard	miliard
premier	premier
margines	margines
komunikat	komunikat
nazwa	nazw
przepis	przepis
kierowca	kierowc
ilość	ilość
inicjatywa	inicjatyw
mocarstwo	mocarstw
negocjacja	negocjacj
zawarcie	zawarci
pokój	pokój
spotkanie	spotkani
wojna	wojn
okładka	okładk
tomik	tomik
wzrok	wzrok
bukiet	bukiet
kwiat	kwiat
rozmowa	rozmow
dyrektor	dyrektor
archiwum	archiwum
świadectwo	świadectw
wkład	wkład
zwycięstwo	zwycięstw
notes	notes
dana	dan
środek	środek
gmina	gmin
kredyt	kredyt
dofinansowanie	dofinansowani
miasto	miast
armia	armi
lawina	lawin
ratownik	ratownik
pies	pies
miejsce	miejsc
osunięcie	osunięci
kanton	kanton
stacja	stacj
zejście	zejści
zbocze	zbocz
rytm	rytm
dłoń	dłoń
góra	gór
ręka	ręk
facet	facet
wschód	wschód
poczekalnia	poczekalni
grupka	grupk
noga	nog
aktówka	aktówk
puszka	puszk
piwo	piw
tom	tom
studium	studium
autor	autor
świeczka	świeczk
zima	zim
zimno	zimn
cholera	choler
bomba	bomb
cud	cud
czort	czort
produkcja	produkcj
recepta	recept
proastmin	proastmin
policjant	policjant
apteka	aptek
destylacja	destylacj
sprzedaż	sprzedaż
partia	parti
komitet	komitet
obywatel	obywatel
okno	okn
gołąb	gołąb
parapet	parapet
pazurek	pazurek
metal	metal
równowaga	równowag
klient	klient
dziwactwo	dziwactw
wejście	wejści
bagażnik	bagażnik
walizeczka	walizeczk
papier	papier
namysł	namysł
wezwanie	wezwani
łyk	łyk
kawa	kaw
kelner	kelner
capuccino	capuccin
pieniądz	pieniądz
ogłoszenie	ogłoszeni
adres	adres
dzień	dzień
list	list
życie	życi
niespodzianka	niespodziank
spojrzenie	spojrzeni
tłum	tłum
sekretarz	sekretarz
południe	południ
zagadnienie	zagadnieni
projektowanie	projektowani
podzespół	podzespół
maszyna	maszyn
uwzględnienie	uwzględnieni
specyfika	specyfik
stan	stan
stosunki	stosunki
interes	interes
wygranie	wygrani
wybory	wybor
okazja	okazj
kadencja	kadencj
prezydentura	prezydentur
cement	cement
wapno	wapn
gips	gips
włos	włos
czoło	czoł
mąż	mąż
czapka	czapk
księżyc	księżyc
chmura	chmur
trawa	traw
świerszcz	świerszcz
gra	gr
zrozumienie	zrozumieni
kark	kark
podwórko	podwórk
namowa	namow
szkoła	szkoł
oddal	oddal
dźwięk	dźwięk
trąbka	trąbk
kopyto	kopyt
błoto	błot
futro	futr
ramię	ramię
pierś	pierś
boisko	boisk
początek	początek
mecz	mecz
piłka	piłk
przesłuchanie	przesłuchani
włamywacz	włamywacz
dziecko	dzieck
włamanie	włamani
kościół	kościół
jeden	jeden
świadek	świadek
policja	policj
uczynek	uczynek
auto	aut
kierunek	kierunek
zdrajca	zdrajc
gangrena	gangren
zniszczenie	zniszczeni
potop	potop
gruz	gruz
świątynia	świątyni
kamień	kamień
stopka	stopk
królowa	królow
rozważanie	rozważani
los	los
pamiątka	pamiątk
nadzieja	nadziej
panna	pann
zaproszenie	zaproszeni
krzesło	krzesł
zjedzenie	zjedzeni
mieszkanie	mieszkani
nastrój	nastrój
warkot	warkot
motor	motor
ulica	ulic
brzęk	brzęk
szyba	szyb
dym	dym
kurz	kurz
podłoga	podłog
potwierdzenie	potwierdzeni
sztab	sztab
pocisk	pocisk
informacja	informacj
mysz	mysz
las	las
kieliszek	kieliszek
plan	plan
klub	klub
tłumacz	tłumacz
piłkarz	piłkarz
sierżant	sierżant
posterunkowy	posterunkow
październik	październik
opiekun	opiekun
suma	sum
członek	członek
komórka	komórk
tomograf	tomograf
tkanka	tkank
organizator	organizator
przerwa	przerw
widz	widz
grochówka	grochówk
budowa	budow
powiat	powiat
włodarz	włodarz
budżet	budżet
tysiąc	tysiąc
złoty	złot
wakacje	wakacj
uroczystość	uroczystość
upominek	upominek
fragment	fragment
trasa	tras
zdawanie	zdawani
resocjalizacja	resocjalizacj
zdanie	zdani
matura	matur
zamiar	zamiar
fizykoterapia	fizykoterapi
gimnazjalista	gimnazjalist
test	test
sala	sal
gimnazjum	gimnazjum
trzecioklasista	trzecioklasist
wiedza	wiedz
poszkodowany	poszkodowan
frank	frank
przedsiębiorstwo	przedsiębiorstw
sposób	sposób
umowa	umow
przetarg	przetarg
drzwi	drzwi
sąd	sąd
zdarzenie	zdarzeni
czerwiec	czerwiec
zło	zł
widzenie	widzeni
natka	natk
marchewka	marchewk
korzeń	korzeń
dodatek	dodatek
twarz	twarz
meliniarstwo	meliniarstw
kilometr	kilometr
diabeł	diabeł
loteryjka	loteryjk
papież	papież
msza	msz
katolik	katolik
imię	imię
kraniec	kraniec
wiek	wiek
promotor	promotor
doktorant	doktorant
wykład	wykład
student	student
proseminarium	proseminarium
seminarium	seminarium
filologia	filologi
historyk	historyk
oddział	oddział
chłop	chłop
dezerter	dezerter
miąższość	miąższość
gleba	gleb
urodzajność	urodzajność
konkurs	konkurs
organizacja	organizacj
master	master
pokazanie	pokazani
ekran	ekran
transport	transport
łączność	łączność
sytuacja	sytuacj
granica	granic
kobieta	kobiet
cykoria	cykori
spółdzielczyni	spółdzielczyni
wieś	wieś
masażysta	masażyst
staw	staw
grobla	grobl
zadumanie	zadumani
zafrasowanie	zafrasowani
program	program
zabawa	zabaw
ciało	ciał
łono	łon
badanie	badani
bakteria	bakteri
zdrowie	zdrowi
reszta	reszt
niewola	niewol
pora	por
wytwórnia	wytwórni
fałszywka	fałszywk
fabryka	fabryk
studolarówka	studolarówk
szpital	szpital
przejazd	przejazd
przód	przód
autobus	autobus
pociąg	pociąg
napastnik	napastnik
zegarek	zegarek
wartość	wartość
potok	potok
uciekinier	uciekinier
rodzina	rodzin
radioodbiornik	radioodbiornik
dostęp	dostęp
żołnierz	żołnierz
partyzant	partyzant
urna	urn
rekompensata	rekompensat
ruina	ruin
orędzie	orędzi
areszt	areszt
pałac	pałac
park	park
apartament	apartament
sypialnia	sypialni
łazienka	łazienk
urząd	urząd
kawiarnia	kawiarni
parasolka	parasolk
zamówienie	zamówieni
zaklinacz	zaklinacz
pogoda	pogod
zalew	zalew
spec	spec
wiatr	wiatr
słońce	słońc
zaklęcie	zaklęci
złamanie	złamani
czaszka	czaszk
zakupienie	zakupieni
butelka	butelk
czwórka	czwórk
wypicie	wypici
trunek	trunek
siedlczann	siedlczann
towarzystwo	towarzystw
przytomność	przytomność
sklep	sklep
pełnienie	pełnieni
funkcja	funkcj
odczucie	odczuci
inwestycja	inwestycj
doświadczenie	doświadczeni
zmęczenie	zmęczeni
tożsamość	tożsamość
realizacja	realizacj
strategia	strategi
dzielenie	dzieleni
parlament	parlament
niezależność	niezależność
wizja	wizj
pomysł	pomysł
centrala	central
czytanie	czytani
skrót	skrót
wydatek	wydatek
kapłan	kapłan
ukaranie	ukarani
prorok	prorok
prawnik	prawnik
karabinier	karabinier
korytarz	korytarz
oskarżenie	oskarżeni
fala	fal
odwołanie	odwołani
podpis	podpis
apel	apel
zakaz	zakaz
broń	broń
bezrobotny	bezrobotn
żona	żon
zeznanie	zeznani
ulga	ulg
rachunek	rachunek
znajomy	znajom
herbata	herbat
szklanka	szklank
córka	córk
syn	syn
brak	brak
osoba	osob
siódemka	siódemk
postępowanie	postępowani
własność	własność
ambasador	ambasador
małżonka	małżonk
zarzut	zarzut
konfiskowanie	konfiskowani
drobiazg	drobiazg
raport	raport
wspólnota	wspólnot
cywil	cywil
porzucanie	porzucani
domostwo	domostw
kapsel	kapsel
uszczelka	uszczelk
napój	napój
posiłek	posiłek
wiceminister	wiceminister
szef	szef
służba	służb
bezpieczeństwo	bezpieczeństw
departament	departament
inwigilacja	inwigilacj
kler	kler
kierowanie	kierowani
porwanie	porwani
zabójstwo	zabójstw
scena	scen
interpretacja	interpretacj
rozbrat	rozbrat
społeczeństwo	społeczeństw
rejon	rejon
obszar	obszar
koncentracja	koncentracj
okręg	okręg
gusła	gusł
muzyka	muzyk
wprowadzenie	wprowadzeni
montaż	montaż
cyfra	cyfr
skup	skup
kwartał	kwartał
rząd	rząd
prymas	prymas
zamierzenie	zamierzeni
gabinet	gabinet
gmach	gmach
kancelaria	kancelari
prezes	prezes
rada	rad
minister	minister
roszczenie	roszczeni
dyspozycja	dyspozycj
racja	racj
sybirak	sybirak
dochodzenie	dochodzeni
zadanie	zadani
rynek	rynek
obrót	obrót
ból	ból
urzędnik	urzędnik
przełożenie	przełożeni
poseł	poseł
lekceważenie	lekceważeni
potrzeba	potrzeb
rolnictwo	rolnictw
szaleństwo	szaleństw
rola	rol
dealer	dealer
warunek	warunek
dostawa	dostaw
kredytowanie	kredytowani
towar	towar
księgowość	księgowość
szkolenie	szkoleni
sieć	sieć
kształt	kształt
postrzał	postrzał
klatka	klatk
prokurator	prokurator
ekspert	ekspert
ćwiczenie	ćwiczeni
rykoszet	rykoszet
napad	napad
wolontariusz	wolontariusz
orkiestra	orkiestr
bęben	bęben
znaczenie	znaczeni
źródło	źródł
odbicie	odbici
prasa	pras
islamista	islamist
taktyka	taktyk
obywatelstwo	obywatelstw
mebel	mebel
nieruchomość	nieruchomość
spółdzielnia	spółdzielni
okoliczność	okoliczność
błąd	błąd
konfiskata	konfiskat
kadra	kadr
napięcie	napięci
poziom	poziom
stopień	stopień
uczenie	uczeni
przykład	przykład
handel	handel
sędzia	sędzi
zwycięzca	zwycięzc
klasyfikacja	klasyfikacj
komentator	komentator
gazeta	gazet
pozyskiwanie	pozyskiwani
mleko	mlek
przewodniczący	przewodnicząc
wrażenie	wrażeni
antyfrancuskość	antyfrancuskość
polityka	polityk
antologia	antologi
wiosna	wiosn
poezja	poezj
przekład	przekład
inklinacja	inklinacj
panienka	panienk
picie	pici
posada	posad
ubogi	ubogi
umysł	umysł
woźnica	woźnic
pomocnik	pomocnik
kufer	kufer
pasażer	pasażer
wnętrze	wnętrz
karetka	karetk
wzmianka	wzmiank
kolej	kolej
gwiazda	gwiazd
przyjaźń	przyjaźń
rycerz	rycerz
towarzysz	towarzysz
król	król
babcia	babci
krzyk	krzyk
dłużnik	dłużnik
wczoraj	wczoraj
marzec	marzec
ostateczność	ostateczność
wyrzut	wyrzut
sumienie	sumieni
rozmyślanie	rozmyślani
pogotowie	pogotowi
chwila	chwil
kontrola	kontrol
łóżko	łóżk
piasek	piasek
piaskownica	piaskownic
dziewczyna	dziewczyn
sąsiedztwo	sąsiedztw
warkoczyk	warkoczyk
kokardka	kokardk
blizna	blizn
rower	rower
sygnatura	sygnatur
starodruk	starodruk
trener	trener
targ	targ
banknot	banknot
sen	sen
wódz	wódz
teka	tek
stanowisko	stanowisk
listopad	listopad
wyborca	wyborc
przyczyna	przyczyn
klęska	klęsk
dialog	dialog
muzułmanin	muzułmanin
karykatura	karykatur
lewica	lewic
przeliczenie	przeliczeni
koszt	koszt
idea	ide
solidarność	solidarność
kongres	kongres
rzeka	rzek
hasło	hasł
przemówienie	przemówieni
stosunek	stosunek
mówca	mówc
reakcja	reakcj
kapitalista	kapitalist
konserwatysta	konserwatyst
przywódca	przywódc
nienawiść	nienawiść
hipokryzja	hipokryzj
filmik	filmik
chamstwo	chamstw
złudzenie	złudzeni
milicja	milicj
karuzela	karuzel
nazwisko	nazwisk
pretendent	pretendent
ratusz	ratusz
konkret	konkret
kwiecień	kwiecień
udział	udział
seans	seans
strach	strach
sojusznik	sojusznik
samoobrona	samoobron
zaprzestanie	zaprzestani
strajk	strajk
maniak	maniak
radio	radi
realia	reali
atak	atak
środowisko	środowisk
medium	medium
przypadek	przypadek
wierzchołek	wierzchołek
drzewo	drzew
burza	burz
lato	lat
nominacja	nominacj
zwyżka	zwyżk
cena	cen
szkoleniowiec	szkoleniowiec
blokada	blokad
wypowiedź	wypowiedź
kierownictwo	kierownictw
pełnomocnik	pełnomocnik
strój	strój
opracowanie	opracowani
mechanizm	mechanizm
zamieszanie	zamieszani
arogancja	arogancj
zawłaszczanie	zawłaszczani
weryfikacja	weryfikacj
telewizja	telewizj
unia	uni
wolność	wolność
byt	byt
oprzyrządowanie	oprzyrządowani
motywacja	motywacj
lokomotywa	lokomotyw
pływanie	pływani
pierwsza	pierwsz
zgoda	zgod
wyjazd	wyjazd
przeciwnik	przeciwnik
obóz	obóz
etykietka	etykietk
wykładnia	wykładni
dzieje	dziej
ugrupowanie	ugrupowani
zjawisko	zjawisk
województwo	województw
tworzenie	tworzeni
blok	blok
wygląd	wygląd
prezencja	prezencj
atut	atut
kandydat	kandydat
znajomość	znajomość
język	język
doktor	doktor
psychika	psychik
morale	moral
klucz	klucz
boks	boks
ogół	ogół
obrona	obron
odpowiedzialność	odpowiedzialność
kompetencja	kompetencj
katechizacja	katechizacj
treść	treść
wiara	wiar
ideologia	ideologi
intencja	intencj
zwolennik	zwolennik
laicyzacja	laicyzacj
ingerencja	ingerencj
prawica	prawic
edukacja	edukacj
logopeda	logoped
specjalista	specjalist
image	imag
mistrzostwa	mistrzostw
szmat	szmat
mundial	mundial
grudzień	grudzień
wydobycie	wydobyci
węgiel	węgiel
tona	ton
gwarancja	gwarancj
postawa	postaw
bocznica	bocznic
wagon	wagon
materiał	materiał
surowiec	surowiec
platforma	platform
miara	miar
partner	partner
koalicja	koalicj
pretensja	pretensj
wiktoria	wiktori
czwartek	czwartek
prom	prom
katastrofa	katastrof
mila	mil
port	port
północ	północ
radar	radar
wieść	wieść
drżenie	drżeni
krąg	krąg
powód	powód
skrócenie	skróceni
finansowanie	finansowani
samolot	samolot
finanse	finans
słuchawka	słuchawk
obejście	obejści
ogon	ogon
buda	bud
sufit	sufit
kapitan	kapitan
anioł	anioł
kara	kar
sprawca	sprawc
pożar	pożar
nieletni	nieletni
próbka	próbk
ścisłość	ścisłość
pewność	pewność
ogródek	ogródek
dzieło	dzieł
fizyka	fizyk
botanik	botanik
astronom	astronom
badacz	badacz
czynność	czynność
mózg	mózg
brud	brud
tworzywo	tworzyw
natura	natur
intuicja	intuicj
istnienie	istnieni
troska	trosk
harmonia	harmoni
nadwozie	nadwozi
dach	dach
kolor	kolor
barwa	barw
krakowianin	krakowianin
ochrona	ochron
liceum	liceum
rozpoczęcie	rozpoczęci
brama	bram
wieczór	wieczór
gang	gang
konstrukcja	konstrukcj
nasyp	nasyp
długość	długość
obwodnica	obwodnic
żywioł	żywioł
zarząd	zarząd
starostwo	starostw
środa	środ
wtorek	wtorek
podniesienie	podniesieni
talerz	talerz
kawałek	kawałek
karp	karp
filiżanka	filiżank
barszcz	barszcz
grusza	grusz
owoc	owoc
plecy	plec
pień	pień
uczucie	uczuci
połowa	połow
sens	sens
szept	szept
kosteczka	kosteczk
gwiazdka	gwiazdk
opłatek	opłatek
sprzęt	sprzęt
akademik	akademik
walet	walet
przyjaciel	przyjaciel
tatuś	tatuś
fotel	fotel
rzut	rzut
pornografia	pornografi
wyróżnienie	wyróżnieni
muzyk	muzyk
stres	stres
zachowanie	zachowani
krzywizna	krzywizn
kręgosłup	kręgosłup
biodro	biodr
tył	tył
wyobraźnia	wyobraźni
spódniczka	spódniczk
stos	stos
wentyl	wentyl
gimnastyka	gimnastyk
mięta	mięt
sztuka	sztuk
pisarz	pisarz
malarz	malarz
poeta	poet
współpraca	współprac
oferta	ofert
piekło	piekł
gospodarz	gospodarz
furia	furi
cukier	cukier
psikanie	psikani
lodówka	lodówk
stolik	stolik
resztka	resztk
mozzarella	mozzarell
opakowanie	opakowani
salami	salami
słoiczek	słoiczek
masło	masł
alkohol	alkohol
pochodzenie	pochodzeni
skala	skal
ciężar	ciężar
przemiana	przemian
wzgląd	wzgląd
lista	list
przedstawicielstwo	przedstawicielstw
firma	firm
wymaganie	wymagani
łódź	łódź
płomień	płomień
strażak	strażak
zwłoki	zwłoki
skin	skin
akt	akt
przejaw	przejaw
agresja	agresj
sweter	sweter
robota	robot
rozdział	rozdział
uśmiech	uśmiech
torba	torb
manierka	manierk
obraz	obraz
utrata	utrat
dech	dech
ociężałość	ociężałość
przyjemność	przyjemność
trud	trud
pokos	pokos
marynarz	marynarz
formacja	formacj
generał	generał
policzek	policzek
łza	łz
milczenie	milczeni
ikona	ikon
cóż	cóż
gówniarz	gówniarz
powstanie	powstani
von	von
personel	personel
kasyno	kasyn
gość	gość
cygaro	cygar
zamyślenie	zamyśleni
stary	star
rozterka	rozterk
samowar	samowar
plebania	plebani
kres	kres
konwersacja	konwersacj
mały	mał
paw	paw
tapczan	tapczan
śniadanie	śniadani
orzech	orzech
szczęka	szczęk
zabranie	zabrani
tryb	tryb
sprostowanie	sprostowani
dyskusja	dyskusj
zaczepka	zaczepk
polemika	polemik
ława	ław
odpowiadanie	odpowiadani
oświadczenie	oświadczeni
koło	koł
lekarka	lekark
obrońca	obrońc
kasta	kast
odmienność	odmienność
syneczek	syneczek
siedzenie	siedzeni
jezioro	jezior
rondo	rond
aleja	alej
ziarno	ziarn
niepokój	niepokój
krowa	krow
jidysz	jidysz
tło	tł
płacz	płacz
transakcja	transakcj
ciąg	ciąg
wykup	wykup
zwrot	zwrot
bonifikata	bonifikat
obowiązek	obowiązek
komornik	komornik
zamieszkanie	zamieszkani
drzewostan	drzewostan
proszek	proszek
pranie	prani
kochanie	kochani
styl	styl
zajmowanie	zajmowani
reagowanie	reagowani
inny	inn
wsparcie	wsparci
możliwość	możliwość
wylot	wylot
rzeczka	rzeczk
morze	morz
koryto	koryt
gospodyni	gospodyni
brew	brew
światło	światł
dziura	dziur
wędkarz	wędkarz
wieloryb	wieloryb
wybrzeże	wybrzeż
odejście	odejści
kształtowanie	kształtowani
wysokość	wysokość
płaca	płac
wariant	wariant
rakieta	rakiet
pięść	pięść
wuj	wuj
waga	wag
promień	promień
pył	pył
zarost	zarost
koszula	koszul
płaszcz	płaszcz
niebo	nieb
gryps	gryps
szczur	szczur
matka	matk
karbidówka	karbidówk
świeca	świec
but	but
skarpeta	skarpet
opał	opał
karbid	karbid
piwnica	piwnic
kupiec	kupiec
ślina	ślin
usypisko	usypisk
śmieć	śmieć
zniżka	zniżk
schronisko	schronisk
zdjęcie	zdjęci
bandyta	bandyt
kałasznikow	kałasznikow
kontrowersja	kontrowersj
rekonstrukcja	rekonstrukcj
przekaz	przekaz
korpus	korpus
rzeźba	rzeźb
odlew	odlew
kamyk	kamyk
mozaika	mozaik
madonna	madonn
powierzchnia	powierzchni
ikonografia	ikonografi
szczęśliwiec	szczęśliwiec
promil	promil
krew	krew
narażenie	narażeni
niebezpieczeństwo	niebezpieczeństw
komenda	komend
mieszkanka	mieszkank
spółka	spółk
stawka	stawk
wywóz	wywóz
nieczystość	nieczystość
pomysłowość	pomysłowość
projektant	projektant
semestr	semestr
topografia	topografi
uczelnia	uczelni
psychol	psychol
tramwaj	tramwaj
ścierwo	ścierw
vectra	vectr
bryka	bryk
komis	komis
fotografik	fotografik
ramy	ram
teczka	teczk
jesień	jesień
ograniczenie	ograniczeni
import	import
ogród	ogród
szurgot	szurgot
opona	opon
poemat	poemat
kosmita	kosmit
cisza	cisz
dziewczynka	dziewczynk
obrażenie	obrażeni
strata	strat
dolar	dolar
rezerwa	rezerw
ropa	rop
eksporter	eksporter
licznik	licznik
liczba	liczb
edycja	edycj
młodzieniec	młodzieniec
regał	regał
koszyk	koszyk
starosta	starost
uruchomienie	uruchomieni
strefa	stref
biopaliwo	biopaliw
wyrób	wyrób
rękodzieło	rękodzieł
rozbieżność	rozbieżność
rzetelność	rzetelność
wyjaśnienie	wyjaśnieni
nieścisłość	nieścisłość
gorąco	gorąc
śledztwo	śledztw
rozbój	rozbój
przestępstwo	przestępstw
śnieg	śnieg
zagrożenie	zagrożeni
szmata	szmat
posłanie	posłani
reporter	reporter
ogień	ogień
uczestnik	uczestnik
libacja	libacj
wyprawa	wypraw
litr	litr
paliwo	paliw
przejechanie	przejechani
wydział	wydział
dziennikarstwo	dziennikarstw
nauka	nauk
uniwersytet	uniwersytet
pojazd	pojazd
woń	woń
strzecha	strzech
stowarzyszenie	stowarzyszeni
rozwój	rozwój
okolica	okolic
przejście	przejści
pieszy	piesz
mag	mag
taran	taran
czar	czar
impotencja	impotencj
flanka	flank
mur	mur
bastion	bastion
bierność	bierność
godność	godność
pozór	pozór
starcie	starci
ochroniarz	ochroniarz
odpoczynek	odpoczynek
wyścig	wyścig
wpływ	wpływ
kostium	kostium
obciążenie	obciążeni
śmiertelnik	śmiertelnik
przedstawienie	przedstawieni
miłość	miłość
świętość	świętość
cierpienie	cierpieni
zachwyt	zachwyt
komplement	komplement
ciasto	ciast
talent	talent
chodnik	chodnik
inność	inność
nietolerancja	nietolerancj
pozbawienie	pozbawieni
odszkodowanie	odszkodowani
synagoga	synagog
bocian	bocian
rozkrok	rozkrok
akademia	akademi
porzucenie	porzuceni
noworodek	noworodek
epitet	epitet
kłamstwo	kłamstw
redakcja	redakcj
tendencyjność	tendencyjność
obiektywizm	obiektywizm
uzyskanie	uzyskani
dowód	dowód
ekspertyza	ekspertyz
ubranie	ubrani
przedmiot	przedmiot
łup	łup
nazwanie	nazwani
personalizm	personalizm
pedofilia	pedofili
prawdopodobieństwo	prawdopodobieństw
dowództwo	dowództw
grafficiarz	grafficiarz
chłopiec	chłopiec
dorosły	dorosł
młodzież	młodzież
chrzcielnica	chrzcielnic
układ	układ
ustalenie	ustaleni
rozmiar	rozmiar
reguła	reguł
opór	opór
ułatwienie	ułatwieni
wyszukiwarka	wyszukiwark
ruch	ruch
adrenalina	adrenalin
słuch	słuch
pokład	pokład
pirat	pirat
wyznanie	wyznani
kilogram	kilogram
podatek	podatek
tenisista	tenisist
odwaga	odwag
pech	pech
dziedzina	dziedzin
skuteczność	skuteczność
trudność	trudność
udowodnienie	udowodnieni
molestowanie	molestowani
tytuł	tytuł
arcydzieło	arcydzieł
narzeczona	narzeczon
tata	tat
monitor	monitor
ciocia	cioci
wideofon	wideofon
piosenka	piosenk
taksówka	taksówk
oddalenie	oddaleni
minibus	minibus
afisz	afisz
szyld	szyld
tabliczka	tabliczk
witraż	witraż
bruderszaft	bruderszaft
plecak	plecak
dupek	dupek
wiadro	wiadr
kaptur	kaptur
stragan	stragan
deszcz	deszcz
posadzka	posadzk
myśl	myśl
rzeczywistość	rzeczywistość
przeżycie	przeżyci
akustyka	akustyk
štoček	štoček
hmotnost	hmotnost
pečivo	pečiv
připomínka	připomínk
chléb	chléb
dodavatel	dodavatel
reklamace	reklamac
norma	norm
pravda	pravd
janek	janek
meziříčí	meziříčí
ustanovení	ustanovení
účinnost	účinnost
čsn	čsn
výrobce	výrobc
možnost	možnost
výrobek	výrobek
dohoda	dohod
odběratel	odběratel
situace	situac
obal	obal
skutečnost	skutečnost
kvalita	kvalit
zboží	zboží
prodejce	prodejc
přejímka	přejímk
prodej	prodej
sleva	slev
odchylka	odchylk
počet	počet
kus	kus
g`gram	g`gram
závada	závad
spotřebitel	spotřebitel
způsob	způsob
ceník	ceník
cenovka	cenovk
tabule	tabul
informace	informac
většina	většin
zákon	zákon
číslo	čísl
ochrana	ochran
povinnost	povinnost
míra	mír
množství	množství
klamání	klamání
uvádění	uvádění
údaj	údaj
vlastnost	vlastnost
zákoník	zákoník
věc	věc
jakost	jakost
právo	práv
dodržování	dodržování
sankce	sankc
inspektor	inspektor
obrázek	obrázek
tisk	tisk
rychlost	rychlost
s`sekunda	s`sekund
mm`milimetr	mm`milimetr
popis	popis
fax	fax
volba	volb
hlavička	hlavičk
řezání	řezání
papír	papír
vyzvednutí	vyzvednutí
zpráva	zpráv
polling	polling
vysílání	vysílání
použití	použití
kopírka	kopírk
připojení	připojení
záznamník	záznamník
ovládání	ovládání
shrnutí	shrnutí
vybavení	vybavení
přístroj	přístroj
řešení	řešení
podnikatel	podnikatel
kancelář	kancelář
personál	personál
provoz	provoz
kontilití	kontilití
huť	huť
společnost	společnost
soubor	soubor
zařízení	zařízení
odlévání	odlévání
ocel	ocel
montáž	montáž
výstavba	výstavb
železárna	železárn
měsíc	měsíc
etapa	etap
výroba	výrob
letadlo	letadl
výcvik	výcvik
armáda	armád
dodávka	dodávk
stroj	stroj
zájemce	zájemc
let	let
zakázka	zakázk
palivo	paliv
čtvrtletí	čtvrtletí
bionafta	bionaft
podnik	podnik
trh	trh
tuna	tun
olej	olej
výhoda	výhod
mikroorganismus	mikroorganismus
látka	látk
traktor	traktor
oblast	oblast
mazání	mazání
pila	pil
hospodářství	hospodářství
závod	závod
druh	druh
maličkost	maličkost
konkurence	konkurenc
vesnice	vesnic
nedávno	nedávn
monopol	monopol
zásobování	zásobování
důsledek	důsledek
soukromník	soukromník
úspěch	úspěch
soused	soused
domek	domek
obchod	obchod
zákazník	zákazník
dovoz	dovoz
hodina	hodin
pekárna	pekárn
obec	obec
cesta	cest
zvýhodnění	zvýhodnění
nákup	nákup
známka	známk
průkazka	průkazk
hodnota	hodnot
částka	částk
závěr	závěr
prodejna	prodejn
regál	regál
vedoucí	vedoucí
zásoba	zásob
případ	případ
postih	postih
začátek	začátek
leden	leden
tuk	tuk
prostředek	prostředek
cukr	cukr
nápad	nápad
podoba	podob
zásobení	zásobení
rubrika	rubrik
honorář	honorář
prémie	prémi
slosování	slosování
koruna	korun
praxe	prax
čtenář	čtenář
dopisovatel	dopisovatel
vůz	vůz
růst	růst
bankrot	bankrot
otázka	otázk
profit	profit
manažer	manažer
čelo	čel
odpověď	odpověď
dvojstrana	dvojstran
benzín	benzín
země	země
indikátor	indikátor
nálada	nálad
člověk	člověk
zvýšení	zvýšení
strana	stran
rozhodnutí	rozhodnutí
zvážení	zvážení
koupě	koupě
souboj	souboj
dik	dik
válka	válk
fond	fond
dušička	dušičk
představa	představ
rozhovor	rozhovor
ztráta	ztrát
automobilka	automobilk
krize	kriz
květen	květen
reportáž	reportáž
dluh	dluh
výše	výš
potíž	potíž
zaměstnanec	zaměstnanec
naděje	naděj
příchod	příchod
období	období
propad	propad
jednání	jednání
banka	bank
úprava	úprav
podmínka	podmínk
splácení	splácení
úvěr	úvěr
získání	získání
pokračování	pokračování
očekávání	očekávání
výluka	výluk
počátek	počátek
srpen	srpen
den	den
činnost	činnost
automobil	automobil
vozidlo	vozidl
výsledek	výsledek
propouštění	propouštění
vítězství	vítězství
soutěž	soutěž
kamión	kamión
místo	míst
klasifikace	klasifikac
rallye	rally
názor	názor
hlas	hlas
pramen	pramen
opatření	opatření
snížení	snížení
výkon	výkon
organismus	organismus
obrátka	obrátk
pochybnost	pochybnost
spekulace	spekulac
vývoj	vývoj
ukazatel	ukazatel
příjem	příjem
turistika	turistik
rezerva	rezerv
odhad	odhad
výhled	výhled
poradce	poradc
daň	daň
úřad	úřad
dotaz	dotaz
dph	dph
sdružení	sdružení
základ	základ
zprostředkování	zprostředkování
ručení	ručení
plátce	plátc
odnož	odnož
odstavec	odstavec
plnění	plnění
smlouva	smlouv
obrat	obrat
rámec	rámec
hranice	hranic
podíl	podíl
okolnost	okolnost
důvod	důvod
uzavření	uzavření
limit	limit
řada	řad
koncert	koncert
riziko	rizik
vystoupení	vystoupení
vstupné	vstupné
návštěva	návštěv
slovo	slov
posluchač	posluchač
nadšení	nadšení
zapomnění	zapomnění
dynamika	dynamik
hudba	hudb
mlha	mlh
pohyb	pohyb
útroby	útrob
hala	hal
pořadatel	pořadatel
zisk	zisk
milión	milión
pětistovka	pětistovk
hra	hr
dobrodiní	dobrodiní
západ	západ
pšenka	pšenk
turné	turné
termín	termín
vstupenka	vstupenk
divák	divák
dem	dem
stovka	stovk
rozdíl	rozdíl
východ	východ
skončení	skončení
voda	vod
pořádání	pořádání
palác	palác
sport	sport
úroveň	úroveň
start	start
ředitel	ředitel
vstup	vstup
noc	noc
ekonomika	ekonomik
nabídka	nabídk
poptávka	poptávk
minimum	minimum
usd	usd
lavina	lavin
pozice	pozic
trend	trend
přehled	přehled
rider	rider
alfa	alf
omega	omeg
zavěšení	zavěšení
pódium	pódium
horolezec	horolezec
garance	garanc
chod	chod
publicita	publicit
návštěvnost	návštěvnost
televize	televiz
rozhlas	rozhlas
plakát	plakát
leták	leták
médium	médium
plocha	ploch
peníze	peníz
risk	risk
starost	starost
průběh	průběh
kino	kin
vodotisk	vodotisk
finesa	fines
zfalšování	zfalšování
sto	st
kontrolor	kontrolor
padesátka	padesátk
záda	zád
hudebník	hudebník
specialista	specialist
přesnost	přesnost
fanoušek	fanoušek
dělení	dělení
tržba	tržb
kapela	kapel
zeď	zeď
účet	účet
dispozice	dispozic
propagace	propagac
náklad	náklad
reklama	reklam
ochranka	ochrank
poplatek	poplatek
převod	převod
strava	strav
pracovník	pracovník
příprava	příprav
celník	celník
svaz	svaz
ubytování	ubytování
kapsa	kaps
polovina	polovin
obava	obav
peníz	peníz
umění	umění
souvislost	souvislost
prodělek	prodělek
pohled	pohled
přežití	přežití
produkce	produkc
zahrnutí	zahrnutí
faktor	faktor
nula	nul
lístek	lístek
producent	producent
kšeft	kšeft
počasí	počasí
stadión	stadión
vztah	vztah
prostřednictví	prostřednictví
předprodej	předprodej
zásah	zásah
podpora	podpor
účast	účast
dvojnásobek	dvojnásobek
odečtení	odečtení
výbor	výbor
vůle	vůl
foto	fot
odklad	odklad
placení	placení
předpoklad	předpoklad
obyvatelstvo	obyvatelstv
podnikání	podnikání
ohled	ohled
výklad	výklad
vysvětlení	vysvětlení
téma	tém
ministerstvo	ministerstv
finance	financ
poplatník	poplatník
rejstřík	rejstřík
zaměstnání	zaměstnání
důchod	důchod
zabezpečení	zabezpečení
uplatnění	uplatnění
vznik	vznik
osvobození	osvobození
nárok	nárok
odložení	odložení
rozvoj	rozvoj
majetek	majetek
dkp	dkp
materiál	materiál
oprava	oprav
údržba	údržb
nabytí	nabytí
význam	význam
zrušení	zrušení
doplacení	doplacení
text	text
kresba	kresb
bolení	bolení
hlava	hlav
reflex	reflex
zpěvačka	zpěvačk
akce	akc
mečení	mečení
kůzlátko	kůzlátk
farma	farm
manžel	manžel
budoucnost	budoucnost
perla	perl
článek	článek
krumlesco	krumlesc
poklad	poklad
kuriozita	kuriozit
monument	monument
přehrada	přehrad
vrchol	vrchol
kopec	kopec
zahradník	zahradník
kauza	kauz
expert	expert
využití	využití
senior	senior
organizace	organizac
půda	půd
prosinec	prosinec
koncipování	koncipování
management	management
motivace	motivac
tvorba	tvorb
plán	plán
vedení	vedení
katalog	katalog
stupeň	stupeň
řízení	řízení
snaha	snah
zkušenost	zkušenost
působení	působení
koncept	koncept
zveřejnění	zveřejnění
spolupráce	spoluprác
kompetence	kompetenc
problém	problém
přístup	přístup
práce	prác
vliv	vliv
generace	generac
poznatek	poznatek
srovnání	srovnání
konzultace	konzultac
nedostatek	nedostatek
příležitost	příležitost
úvaha	úvah
stránka	stránk
potřeba	potřeb
nebezpečí	nebezpečí
omezování	omezování
operace	operac
systém	systém
úvěrování	úvěrování
sazba	sazb
používání	používání
šek	šek
říjen	říjen
kaktus	kaktus
lékárna	lékárn
ulice	ulic
mast	mast
gel	gel
návod	návod
čeština	češtin
předpis	předpis
součást	součást
překlad	překlad
pacient	pacient
lék	lék
tableta	tablet
lékař	lékař
kontraindikace	kontraindikac
účinek	účinek
ospalost	ospalost
vhodnost	vhodnost
léčba	léčb
pučálka	pučálk
instalace	instalac
fólie	fóli
oddělení	oddělení
dřeň	dřeň
klinika	klinik
nemocnice	nemocnic
prostředí	prostředí
dílo	díl
ekonom	ekonom
tvrzení	tvrzení
škola	škol
únor	únor
kaple	kapl
rektor	rektor
znalost	znalost
pravidlo	pravidl
hlad	hlad
prostora	prostor
ráno	rán
večer	večer
budova	budov
ústav	ústav
vzdělání	vzdělání
posila	posil
předmět	předmět
hochschule	hochschul
disciplína	disciplín
výuka	výuk
měřítko	měřítk
absolvent	absolvent
zaměření	zaměření
odpovědnost	odpovědnost
zájem	zájem
obor	obor
učitel	učitel
plat	plat
strop	strop
docent	docent
asistent	asistent
rozpočet	rozpočet
zlepšení	zlepšení
mzda	mzd
odborník	odborník
povolání	povolání
aktivita	aktivit
revoluce	revoluc
rozhled	rozhled
praktikant	praktikant
poskytování	poskytování
tajemství	tajemství
část	část
péče	péč
stipendium	stipendium
námět	námět
výstava	výstav
nábytek	nábytek
gastronomie	gastronomi
agentura	agentur
chyba	chyb
splatnost	splatnost
faktura	faktur
odběr	odběr
objednávka	objednávk
čtvrt	čtvrt
hotovost	hotovost
domluva	domluv
office	offic
box	box
přijímání	přijímání
zástupce	zástupc
dopis	dopis
urgence	urgenc
pohrůžka	pohrůžk
projednání	projednání
platba	platb
pokoj	pokoj
újma	újm
zdraví	zdraví
život	život
zaplacení	zaplacení
poučení	poučení
složení	složení
záloha	záloh
opatrnost	opatrnost
dojem	dojem
příspěvek	příspěvek
minulost	minulost
porovnání	porovnání
vývoz	vývoz
výměna	výměn
položka	položk
export	export
letoun	letoun
vrtulník	vrtulník
potravina	potravin
textil	textil
tendence	tendenc
investice	investic
léto	lét
venture	ventur
bota	bot
rozšiřování	rozšiřování
modernizace	modernizac
letiště	letiště
služba	služb
poradenství	poradenství
cíl	cíl
síla	síl
úkol	úkol
spojení	spojení
zjednodušení	zjednodušení
seminář	seminář
obchodování	obchodování
dotazník	dotazník
žádost	žádost
šance	šanc
bulletin	bulletin
dovozce	dovozc
provincie	provinci
posílení	posílení
doklad	doklad
občan	občan
pas	pas
vízum	vízum
povolení	povolení
potvrzení	potvrzení
cizinec	cizinec
imigrace	imigrac
posuzování	posuzování
nezaměstnanost	nezaměstnanost
velvyslanectví	velvyslanectví
byznys	byznys
století	století
krádež	krádež
hygiena	hygien
koupání	koupání
vana	van
pohoda	pohod
cyklus	cyklus
domácnost	domácnost
týdeník	týdeník
rozdělení	rozdělení
rádce	rádc
vůně	vůně
zneužití	zneužití
nástroj	nástroj
speciál	speciál
kapacita	kapacit
sledování	sledování
vítěz	vítěz
vlna	vln
privatizace	privatizac
procento	procent
bod	bod
stůl	stůl
tip	tip
kolo	kol
tisíc	tisíc
redakce	redakc
lázně	lázně
pán	pán
výherce	výherc
přednost	přednost
specifikum	specifikum
ležák	ležák
drátek	drátek
krám	krám
majitel	majitel
neděle	neděl
odpoledne	odpoledn
pondělek	pondělek
úterek	úterek
středa	střed
čtvrtek	čtvrtek
průměr	průměr
pátek	pátek
půl	půl
zářivka	zářivk
mrazák	mrazák
chips	chips
konzerva	konzerv
káva	káv
zahájení	zahájení
cibule	cibul
jablko	jablk
zahrada	zahrad
vejce	vejc
dvacetník	dvacetník
desetník	desetník
nevýhoda	nevýhod
marže	marž
role	rol
nádraží	nádraží
velkoobchod	velkoobchod
drogerie	drogeri
nárůst	nárůst
psč	psč
dítě	dítě
stravování	stravování
polopenze	polopenz
poukázka	poukázk
doprava	doprav
parkování	parkování
garáž	garáž
výška	výšk
m`metr	m`metr
moře	moř
km`kilometr	km`kilometr
příroda	přírod
houbaření	houbaření
střed	střed
bazén	bazén
sprcha	sprch
půjčovna	půjčovn
hřiště	hřiště
televizor	televizor
pobyt	pobyt
pes	pes
host	host
vinárna	vinárn
spolupracovník	spolupracovník
výpočet	výpočet
nájem	nájem
obcházení	obcházení
pronájem	pronájem
úhrada	úhrad
nájemné	nájemné
zdanění	zdanění
sdělení	sdělení
zpravodaj	zpravodaj
poskytnutí	poskytnutí
zaměstnavatel	zaměstnavatel
účel	účel
judr	judr
phdr	phdr
nástup	nástup
lovec	lovec
angličtina	angličtin
headhunter	headhunter
kopfjäger	kopfjäger
název	název
vyhledávání	vyhledávání
výběr	výběr
kandidát	kandidát
záležitost	záležitost
muž	muž
požadavek	požadavek
záplava	záplav
filiálka	filiálk
databanka	databank
recese	reces
personalistika	personalistik
kopfjägern	kopfjägern
zlato	zlat
nalezení	nalezení
geschäftsführer	geschäftsführer
šilink	šilink
sekretářka	sekretářk
inzerát	inzerát
vyhledání	vyhledání
pobočka	pobočk
nápor	nápor
zkušený	zkušený
zodpovědnost	zodpovědnost
funkce	funkc
schopnost	schopnost
pohovor	pohovor
procedura	procedur
renovace	renovac
dřevo	dřev
replika	replik
kompletace	kompletac
vrácení	vrácení
pohostinství	pohostinství
datum	datum
průkaz	průkaz
oprávnění	oprávnění
splnění	splnění
provozování	provozování
živnost	živnost
písmeno	písmen
uplynutí	uplynutí
ukončení	ukončení
lhůta	lhůt
vydání	vydání
délka	délk
izolace	izolac
družstvo	družstv
upozorňování	upozorňování
odstranění	odstranění
plzeň	plzeň
užívání	užívání
pronajímatel	pronajímatel
nájemce	nájemc
existence	existenc
zásada	zásad
upozornění	upozornění
náhrada	náhrad
trvání	trvání
přiměřenost	přiměřenost
spor	spor
soud	soud
prospěch	prospěch
břemeno	břemen
bydlení	bydlení
místnost	místnost
patro	patr
přízemí	přízemí
věk	věk
stav	stav
notář	notář
složka	složk
vymezení	vymezení
obsah	obsah
rozsah	rozsah
vlastník	vlastník
dům	dům
otop	otop
elektřina	elektřin
úklid	úklid
ujednání	ujednání
zřízení	zřízení
úplnost	úplnost
zánik	zánik
soulad	soulad
zápis	zápis
nemovitost	nemovitost
vklad	vklad
katastr	katastr
doručení	doručení
návrh	návrh
ilustrace	ilustrac
major	major
prvek	prvek
taktika	taktik
strategie	strategi
průlom	průlom
obchvat	obchvat
boj	boj
pochod	pochod
překvapení	překvapení
ostrov	ostrov
sídlo	sídl
pírko	pírk
konec	konec
hrabství	hrabství
vzhled	vzhled
areál	areál
zeleň	zeleň
strom	strom
keř	keř
kritérium	kritérium
tradice	tradic
příslušenství	příslušenství
díl	díl
původ	původ
zbytek	zbytek
libra	libr
dělník	dělník
svět	svět
parametr	parametr
poloha	poloh
továrna	továrn
subdodavatel	subdodavatel
chvíle	chvíl
součástka	součástk
bedna	bedn
štítek	štítek
spotřeba	spotřeb
dispečink	dispečink
svoz	svoz
uchazeč	uchazeč
snímek	snímek
centrála	centrál
schůzka	schůzk
pracoviště	pracoviště
novinka	novink
minuta	minut
přestávka	přestávk
zkouška	zkoušk
perspektiva	perspektiv
fluktuace	fluktuac
argument	argument
komise	komis
jmenování	jmenování
fáze	fáz
stabilizace	stabilizac
linka	link
nadřízený	nadřízený
zastavení	zastavení
hnutí	hnutí
filozofie	filozofi
realizace	realizac
dohadování	dohadování
otec	otec
oblečení	oblečení
pořádek	pořádek
otazník	otazník
uživatelka	uživatelk
síť	síť
impuls	impuls
vina	vin
zpracování	zpracování
počítač	počítač
uživatel	uživatel
přeplatek	přeplatek
účastník	účastník
námitka	námitk
vědomí	vědomí
příslib	příslib
náprava	náprav
záruka	záruk
březen	březen
úrok	úrok
omluva	omluv
závazek	závazek
postavení	postavení
kalendář	kalendář
učitelka	učitelk
skladba	skladb
prosba	prosb
spousta	spoust
nepříjemnost	nepříjemnost
adresář	adresář
sponzor	sponzor
pořízení	pořízení
velkochov	velkochov
králík	králík
nesolidnost	nesolidnost
krmivo	krmiv
granule	granul
plíseň	plíseň
činitel	činitel
smíchání	smíchání
směs	směs
krůta	krůt
následek	následek
úhyn	úhyn
zvíře	zvíř
plodnost	plodnost
samice	samic
vagón	vagón
vytváření	vytváření
komponenta	komponent
zachování	zachování
šarže	šarž
certifikát	certifikát
farmář	farmář
mlčenlivost	mlčenlivost
likvidace	likvidac
červen	červen
sud	sud
pivovar	pivovar
záměr	záměr
federace	federac
nováček	nováček
pokles	pokles
podbízení	podbízení
dostatek	dostatek
směnka	směnk
zdroj	zdroj
servis	servis
vzdálenost	vzdálenost
ventil	ventil
vypalování	vypalování
kód	kód
laser	laser
svár	svár
technologie	technologi
krupka	krupk
komunikace	komunikac
představitel	představitel
stanovení	stanovení
prostor	prostor
odkoupení	odkoupení
novelizace	novelizac
vyhláška	vyhlášk
tabák	tabák
školení	školení
festival	festival
předseda	předsed
odvětví	odvětví
sklo	skl
bižuterie	bižuteri
investor	investor
surovina	surovin
provedení	provedení
vlákno	vlákn
porcelán	porcelán
průmysl	průmysl
transformace	transformac
zadluženost	zadluženost
rys	rys
rentabilita	rentabilit
stabilita	stabilit
vzestup	vzestup
odbyt	odbyt
neschopnost	neschopnost
produktivita	produktivit
tuzemec	tuzemec
restituce	restituc
akcie	akci
union	union
vertex	vertex
perspektivnost	perspektivnost
hledisko	hledisk
rozptyl	rozptyl
dividenda	dividend
chemie	chemi
čára	čár
komplex	komplex
zapojení	zapojení
útlum	útlum
příčina	příčin
strojírenství	strojírenství
zemědělství	zemědělství
konkurent	konkurent
základna	základn
spektrum	spektrum
hnojivo	hnojiv
petrochemie	petrochemi
analýza	analýz
celek	celek
chemopetrol	chemopetrol
kaučuk	kaučuk
subjekt	subjekt
restrukturalizace	restrukturalizac
plast	plast
prosperita	prosperit
anorganika	anorganik
kyselina	kyselin
louh	louh
sůl	sůl
pryskyřice	pryskyřic
barva	barv
lak	lak
polotovar	polotovar
spolana	spolan
spolek	spolek
chemička	chemičk
móda	mód
barvivo	barviv
pesticid	pesticid
insekticid	insekticid
biofaktor	biofaktor
diagnostika	diagnostik
substance	substanc
léčivo	léčiv
chemikálie	chemikáli
přípravek	přípravek
přísada	přísad
sladidlo	sladidl
kosmetika	kosmetik
gigant	gigant
gmp	gmp
zavedení	zavedení
diverzifikace	diverzifikac
výkyv	výkyv
svátek	svátek
žadatel	žadatel
ujištění	ujištění
pořadí	pořadí
čekání	čekání
klapnutí	klapnutí
jízdné	jízdné
pokládání	pokládání
kabel	kabel
potrubí	potrubí
flow	flow
vrtání	vrtání
silnice	silnic
trať	trať
rozkopávání	rozkopávání
prášek	prášek
hmota	hmot
ocenění	ocenění
ostroh	ostroh
vyhlídka	vyhlídk
dráha	dráh
kúra	kúr
železnice	železnic
budoucno	budoucn
pražec	pražec
stavebnictví	stavebnictví
potenciál	potenciál
zkušebna	zkušebn
povědomí	povědomí
koleno	kolen
zachytávání	zachytávání
odpad	odpad
reorganizace	reorganizac
ředitelství	ředitelství
úsek	úsek
středisko	středisk
výkonnost	výkonnost
výzkum	výzkum
půjčka	půjčk
neznámá	neznámá
reforma	reform
strojírna	strojírn
knížka	knížk
hromada	hromad
výplata	výplat
stokoruna	stokorun
div	div
obrys	obrys
výjimka	výjimk
umístění	umístění
plus	plus
těžba	těžb
uhlí	uhlí
výpadek	výpadek
důl	důl
energie	energi
konverze	konverz
východisko	východisk
horizont	horizont
prognóza	prognóz
revír	revír
optimizmus	optimizmus
rozmezí	rozmezí
dobývání	dobývání
skrývka	skrývk
koncepce	koncepc
stát	stát
mysl	mysl
rekultivovat	rekultivovat
úloha	úloh
omyl	omyl
odbytiště	odbytiště
kalkulace	kalkulac
mašina	mašin
bilance	bilanc
pár	pár
dotace	dotac
výzkumák	výzkumák
inovace	inovac
hledání	hledání
sortiment	sortiment
segment	segment
šrot	šrot
třídírna	třídírn
útvar	útvar
vytěžování	vytěžování
kooperace	kooperac
průzkum	průzkum
priorita	priorit
nositel	nositel
marketing	marketing
blízkost	blízkost
hloubka	hloubk
vtažení	vtažení
oponent	oponent
výstup	výstup
řešitel	řešitel
zajištění	zajištění
citát	citát
vtip	vtip
vánoce	vánoc
obžerství	obžerství
podiv	podiv
kolečko	kolečk
mínění	mínění
obyvatel	obyvatel
pesimista	pesimist
optimista	optimist
převaha	převah
optimismus	optimismus
graf	graf
důkaz	důkaz
pesimismus	pesimismus
realismus	realismus
dosažení	dosažení
statistika	statistik
interpretace	interpretac
terč	terč
bombardování	bombardování
ostřelování	ostřelování
vypuknutí	vypuknutí
sklepení	sklepení
sídliště	sídliště
rozvod	rozvod
stanice	stanic
pásmo	pásm
vkv	vkv
kčs	kčs
kanál	kanál
beseda	besed
úvod	úvod
člen	člen
respektování	respektování
ideologizování	ideologizování
diskuse	diskus
uspořádání	uspořádání
nestraník	nestraník
disident	disident
signatář	signatář
charta	chart
exsocialista	exsocialist
exkomunista	exkomunist
prohlášení	prohlášení
solidarita	solidarit
porozumění	porozumění
usmíření	usmíření
vzor	vzor
zbohatlík	zbohatlík
prázdniny	prázdnin
uprchlík	uprchlík
rodina	rodin
tábor	tábor
desítka	desítk
dobrovolník	dobrovolník
utečenec	utečenec
událost	událost
rodič	rodič
kout	kout
ratolest	ratolest
ústava	ústav
komora	komor
poslanec	poslanec
shromáždění	shromáždění
vláda	vlád
varianta	variant
sněmovna	sněmovn
senát	senát
senátor	senátor
sbor	sbor
soudce	soudc
slučitelnost	slučitelnost
znění	znění
slib	slib
mandát	mandát
dar	dar
převzetí	převzetí
svědomí	svědomí
blaho	blah
velikost	velikost
pravomoc	pravomoc
předsednictvo	předsednictv
orgán	orgán
moloch	moloch
zastoupení	zastoupení
rozpuštění	rozpuštění
okamžik	okamžik
granát	granát
úkryt	úkryt
sloh	sloh
okraj	okraj
území	území
extremista	extremist
útok	útok
okolí	okolí
konvence	konvenc
přijetí	přijetí
udržení	udržení
místopředseda	místopředsed
týden	týden
menšina	menšin
autonomie	autonomi
spravedlnost	spravedlnost
odškodné	odškodné
komplexnost	komplexnost
deník	deník
vojsko	vojsk
borba	borb
nejmenovaný	nejmenovaný
důstojník	důstojník
svazek	svazek
emisar	emisar
tajemník	tajemník
pondělí	pondělí
rozmístění	rozmístění
novinář	novinář
uznání	uznání
společenství	společenství
objev	objev
dirigent	dirigent
skladatel	skladatel
symfonie	symfoni
pianista	pianist
značka	značk
dramaturgie	dramaturgi
láce	lác
deska	desk
pence	penc
příznivec	příznivec
kompakt	kompakt
titul	titul
interpret	interpret
antologie	antologi
label	label
housle	housl
orchestr	orchestr
sólista	sólist
kritika	kritik
nominace	nominac
prestiž	prestiž
klavír	klavír
opera	oper
osud	osud
houslista	houslist
hokej	hokej
tabulka	tabulk
tým	tým
tryskáč	tryskáč
hokejista	hokejist
přestup	přestup
vládce	vládc
skaut	skaut
interview	interview
humor	humor
trocha	troch
nostalgie	nostalgi
pocit	pocit
osobnost	osobnost
veřejnost	veřejnost
přezdívka	přezdívk
bratr	bratr
lektor	lektor
ředitelka	ředitelk
gymnázium	gymnázium
alej	alej
září	září
valorizace	valorizac
odměna	odměn
jazykář	jazykář
dostavba	dostavb
tělocvična	tělocvičn
fasáda	fasád
třída	tříd
anglistika	anglistik
fakulta	fakult
univerzita	univerzit
pakatel	pakatel
latina	latin
italština	italštin
konverzace	konverzac
nadace	nadac
žák	žák
zkvalitnění	zkvalitnění
knihovna	knihovn
výdaj	výdaj
kazeta	kazet
ročník	ročník
reakce	reakc
nadstandard	nadstandard
vyrovnávání	vyrovnávání
zbraň	zbraň
skládání	skládání
domino	domin
summit	summit
podrobnost	podrobnost
vytvoření	vytvoření
instituce	instituc
setkání	setkání
opozice	opozic
kapitulace	kapitulac
čistota	čistot
zamoření	zamoření
tragedie	tragedi
verze	verz
souhlas	souhlas
velení	velení
postoj	postoj
námořnictvo	námořnictv
flotila	flotil
úpornost	úpornost
agenda	agend
rozprava	rozprav
spolehlivost	spolehlivost
velitel	velitel
problematika	problematik
brána	brán
liberalizace	liberalizac
nátlak	nátlak
střet	střet
rubl	rubl
platidlo	platidl
jedenáctka	jedenáctk
přelud	přelud
mez	mez
projev	projev
fórum	fórum
neosobnost	neosobnost
kumulace	kumulac
špice	špic
čin	čin
komunista	komunist
proud	proud
náměstí	náměstí
moravista	moravist
věrohodnost	věrohodnost
záznam	záznam
registr	registr
duben	duben
premiér	premiér
dav	dav
mafia	mafi
sláva	sláv
paní	paní
choť	choť
happening	happening
vyvrácení	vyvrácení
vrata	vrat
růžovo	růžov
tank	tank
kategorie	kategori
stíhání	stíhání
výtržnictví	výtržnictví
zeleno	zelen
štětka	štětk
aféra	afér
pozorovatel	pozorovatel
voják	voják
čtyřicítka	čtyřicítk
červenec	červenec
emigrace	emigrac
vyšetřovatel	vyšetřovatel
kapitán	kapitán
pokus	pokus
puč	puč
výzva	výzv
komuniké	komuniké
poselství	poselství
moucha	mouch
nacionalista	nacionalist
počest	počest
stéblo	stébl
řeka	řek
šovinismus	šovinismus
politik	politik
předstih	předstih
samostatnost	samostatnost
náměstek	náměstek
ministr	ministr
vnitro	vnitr
porada	porad
kabinet	kabinet
kontinuita	kontinuit
posloupnost	posloupnost
neznámo	neznám
provázanost	provázanost
zákonodárství	zákonodárství
počínání	počínání
mise	mis
střelba	střelb
palba	palb
gardista	gardist
intenzita	intenzit
oběť	oběť
kanonáda	kanonád
čtvrť	čtvrť
předměstí	předměstí
ofenzíva	ofenzív
letectvo	letectv
transportér	transportér
sklad	sklad
kolona	kolon
raketa	raket
metropole	metropol
poplach	poplach
srážka	srážk
bojiště	bojiště
vyslanec	vyslanec
zahraničí	zahraničí
zkoumání	zkoumání
vyslání	vyslání
protivník	protivník
posrbšťování	posrbšťování
slabina	slabin
tolerance	toleranc
nejistota	nejistot
mesiáš	mesiáš
dirigismus	dirigismus
totalita	totalit
demokracie	demokraci
vlastnictví	vlastnictví
otevřenost	otevřenost
kritik	kritik
princip	princip
uvolňování	uvolňování
signál	signál
koordinace	koordinac
obnovení	obnovení
regulace	regulac
efektivnost	efektivnost
zrychlení	zrychlení
úpadek	úpadek
otevření	otevření
směnitelnost	směnitelnost
devalvace	devalvac
dynamismus	dynamismus
parita	parit
podhodnocení	podhodnocení
rovnost	rovnost
zlo	zl
marka	mark
bariéra	bariér
zefektivnění	zefektivnění
zhodnocování	zhodnocování
revalvace	revalvac
rovnováha	rovnováh
přidělování	přidělování
deviza	deviz
byrokrat	byrokrat
narůstání	narůstání
váhavost	váhavost
zhodnocení	zhodnocení
otevírání	otevírání
rozhodování	rozhodování
hladina	hladin
demagogičnost	demagogičnost
heslo	hesl
výprodej	výprodej
bohatství	bohatství
transakce	transakc
realokace	realokac
úspora	úspor
restrikce	restrikc
inflace	inflac
orientace	orientac
zmírňování	zmírňování
přechod	přechod
stimulace	stimulac
chování	chování
zvyšování	zvyšování
pozornost	pozornost
šňůra	šňůr
plánování	plánování
profese	profes
prognostik	prognostik
záběr	záběr
tlak	tlak
sektor	sektor
kapitál	kapitál
slabost	slabost
sféra	sfér
preference	preferenc
oddlužování	oddlužování
důležitost	důležitost
iniciativa	iniciativ
mobilita	mobilit
hypotéka	hypoték
akcelerace	akcelerac
zvětšení	zvětšení
zbytnost	zbytnost
zákaz	zákaz
kupón	kupón
koncentrace	koncentrac
důvěryhodnost	důvěryhodnost
úsilí	úsilí
alternativa	alternativ
eskalace	eskalac
spekulant	spekulant
propočet	propočet
úředník	úředník
omezení	omezení
volnost	volnost
rozšíření	rozšíření
šíření	šíření
utváření	utváření
výhrada	výhrad
podstata	podstat
averze	averz
příliv	příliv
styk	styk
zdokonalení	zdokonalení
přítomnost	přítomnost
zábrana	zábran
investování	investování
rizikovost	rizikovost
pozemek	pozemek
vyloučení	vyloučení
stříbro	stříbr
přesun	přesun
demonopolizace	demonopolizac
vykonávání	vykonávání
přesměrování	přesměrování
proměna	proměn
prokuratura	prokuratur
arbitráž	arbitráž
vybudování	vybudování
argumentace	argumentac
výpad	výpad
váha	váh
fundovanost	fundovanost
platnost	platnost
zdravotnictví	zdravotnictví
babička	babičk
žlučník	žlučník
privát	privát
úprk	úprk
lid	lid
novela	novel
pojištění	pojištění
pojišťovna	pojišťovn
trojice	trojic
dvacítka	dvacítk
nedochůdče	nedochůdč
výraz	výraz
tečka	tečk
dýchání	dýchání
tok	tok
administrativa	administrativ
vypisování	vypisování
pokladna	pokladn
doporučení	doporučení
praktik	praktik
obvoďák	obvoďák
odměňování	odměňování
řád	řád
přínos	přínos
předepisování	předepisování
docílení	docílení
pětikoruna	pětikorun
recept	recept
zdražení	zdražení
balík	balík
důchodce	důchodc
dovolená	dovolená
vymáhání	vymáhání
obhajoba	obhajob
neplatič	neplatič
vrstva	vrstv
ošetření	ošetření
klientela	klientel
připojištění	připojištění
injekce	injekc
charita	charit
rozmnožení	rozmnožení
léčitel	léčitel
prodlužování	prodlužování
nemoc	nemoc
krůček	krůček
ordinace	ordinac
licence	licenc
koncese	konces
lékařství	lékařství
hodnocení	hodnocení
stupnice	stupnic
škála	škál
sestra	sestr
programátor	programátor
szp	szp
chirurg	chirurg
ortopéd	ortopéd
spokojenost	spokojenost
informovanost	informovanost
stomatolog	stomatolog
zhoršení	zhoršení
vtah	vtah
užití	užití
medicína	medicín
gynekolog	gynekolog
lůžko	lůžk
divadlo	divadl
mluvčí	mluvčí
atmosféra	atmosfér
netrpělivost	netrpělivost
brždění	brždění
vypětí	vypětí
důslednost	důslednost
chaotičnost	chaotičnost
kúnz	kúnz
legislativa	legislativ
slušnost	slušnost
variace	variac
morálka	morálk
nespravedlnost	nespravedlnost
dřívějšek	dřívějšek
kormidelník	kormidelník
petice	petic
partajník	partajník
rozladění	rozladění
zdravotník	zdravotník
odliv	odliv
získávání	získávání
právník	právník
vpád	vpád
vzdělanost	vzdělanost
písmo	písm
nedůvěra	nedůvěr
torzo	torz
monopolizace	monopolizac
mechanismus	mechanismus
ohodnocení	ohodnocení
formulář	formulář
obtíž	obtíž
blahopřání	blahopřání
chuť	chuť
uklidnění	uklidnění
mistrovství	mistrovství
junior	junior
zápas	zápas
utkání	utkání
hráč	hráč
vážka	vážk
nájezd	nájezd
branka	brank
útočník	útočník
znamení	znamení
zakončení	zakončení
gól	gól
formace	formac
centr	centr
křídlo	křídl
jistota	jistot
klid	klid
brankostroj	brankostroj
hrozba	hrozb
mužstvo	mužstv
nasazení	nasazení
vzpomínka	vzpomínk
kombinace	kombinac
zmínka	zmínk
tyčka	tyčk
brankář	brankář
favorit	favorit
protinávrh	protinávrh
ježek	ježek
sekretář	sekretář
laťka	laťk
vojna	vojn
trenér	trenér
liga	lig
les	les
reprivatizace	reprivatizac
opravárna	opravárn
dílna	díln
pokladnička	pokladničk
kupec	kupec
dražba	dražb
stánek	stánek
vydražování	vydražování
licitátor	licitátor
laboratoř	laboratoř
defektoskopie	defektoskopi
senzace	senzac
majitelka	majitelk
svoboda	svobod
jaro	jar
šéf	šéf
prodloužení	prodloužení
ultrapravice	ultrapravic
nepokoj	nepokoj
násilí	násilí
dnešek	dnešek
pověst	pověst
nedorozumění	nedorozumění
emoce	emoc
předávání	předávání
svědek	svědek
bublina	bublin
odmítnutí	odmítnutí
hospitál	hospitál
fronta	front
řidič	řidič
parkoviště	parkoviště
provozovatel	provozovatel
krejčí	krejčí
autodopravce	autodopravc
clo	cl
průjezd	průjezd
odbavení	odbavení
cvičení	cvičení
prapor	prapor
partnerství	partnerství
mír	mír
usnesení	usnesení
koalice	koalic
obrana	obran
akcionář	akcionář
držitel	držitel
objem	objem
aktivum	aktivum
jméno	jmén
veto	vet
pokraj	pokraj
jih	jih
divize	diviz
soupeř	soupeř
oheň	oheň
sever	sever
sjednocení	sjednocení
zpěvák	zpěvák
hit	hit
shadow	shadow
reduta	redut
píseň	píseň
tradicionál	tradicionál
sun	sun
album	album
doprovod	doprovod
kytara	kytar
sázka	sázk
kalvárie	kalvári
zranění	zranění
smůla	smůl
reprezentace	reprezentac
odjezd	odjezd
šampionát	šampionát
rameno	ramen
soustředění	soustředění
obránce	obránc
led	led
zápěstí	zápěstí
řez	řez
bolest	bolest
tříslo	třísl
odchod	odchod
trénink	trénink
puk	puk
sekunda	sekund
play	pla
výprava	výprav
soupiska	soupisk
kvóta	kvót
horák	horák
sršeň	sršeň
šampón	šampón
jazyk	jazyk
výstřelek	výstřelek
holič	holič
synek	synek
vir	vir
námaha	námah
únava	únav
teplota	teplot
sezona	sezon
narozeniny	narozenin
prohra	prohr
porážka	porážk
čtvrtfinále	čtvrtfinál
neúspěch	neúspěch
účtování	účtování
úkor	úkor
tučňák	tučňák
podtitulek	podtitulek
zápletka	zápletk
podvečer	podvečer
bydliště	bydliště
trosečník	trosečník
inspektorát	inspektorát
označení	označení
computer	computer
autoservis	autoservis
mikrobus	mikrobus
cestování	cestování
spoluhráč	spoluhráč
dres	dres
osmašedesátka	osmašedesátk
jedenadvacítka	jedenadvacítk
bradka	bradk
tvář	tvář
finále	finál
brada	brad
vyřazení	vyřazení
kádr	kádr
trejd	trejd
asistence	asistenc
pád	pád
bonus	bonus
nahrávka	nahrávk
důvěra	důvěr
sestava	sestav
archiv	archiv
arcibiskupství	arcibiskupství
probošství	probošství
hrad	hrad
výročí	výročí
povýšení	povýšení
biskupství	biskupství
položení	položení
kámen	kámen
katedrála	katedrál
motto	mott
myšlenka	myšlenk
církev	církev
exponát	exponát
dějiny	dějin
vůdce	vůdc
smečka	smečk
věznice	věznic
vazba	vazb
trest	trest
vězeň	vězeň
stráž	stráž
lokalita	lokalit
kampaň	kampaň
čokoládovna	čokoládovn
vyjádření	vyjádření
stanovisko	stanovisk
demokrat	demokrat
volič	volič
národ	národ
brčko	brčk
dělo	děl
včerejšek	včerejšek
enkláva	enkláv
dělostřelba	dělostřelb
žena	žen
agrese	agres
pochyba	pochyb
zločin	zločin
konference	konferenc
velvyslankyně	velvyslankyně
sociolog	sociolog
politolog	politolog
sněm	sněm
předsedkyně	předsedkyně
delegace	delegac
bundestag	bundestag
třenice	třenic
ráz	ráz
prolomení	prolomení
legitimita	legitimit
vyhnání	vyhnání
mezník	mezník
garnitura	garnitur
kancléř	kancléř
spojenectví	spojenectví
současnost	současnost
nabídnutí	nabídnutí
gesto	gest
radikalizace	radikalizac
dikce	dikc
algoritmus	algoritmus
logika	logik
sebeobětování	sebeobětování
záchrana	záchran
předcházení	předcházení
sympatie	sympati
reputace	reputac
napomáhání	napomáhání
únik	únik
scéna	scén
vyhnanec	vyhnanec
kandidatura	kandidatur
sousedství	sousedství
praporek	praporek
série	séri
dobrodružství	dobrodružství
zážitek	zážitek
klubíčko	klubíčk
máma	mám
chovatel	chovatel
štěně	štěně
stesk	stesk
pelíšek	pelíšek
postel	postel
domov	domov
hierarchie	hierarchi
procházka	procházk
skříň	skříň
zoubek	zoubek
tón	tón
miláček	miláček
přítel	přítel
přítelkyně	přítelkyně
kříženec	kříženec
ovčák	ovčák
dobrman	dobrman
břicho	břich
porod	porod
křeslo	křesl
divan	divan
dobrák	dobrák
pracka	prack
centimetr	centimetr
teta	tet
tlapa	tlap
pohovka	pohovk
úleva	úlev
ráj	ráj
veterinář	veterinář
osvědčení	osvědčení
očkování	očkování
vzteklina	vzteklin
ženská	ženská
bázlivec	bázlivec
spatření	spatření
výkřik	výkřik
štěňátko	štěňátk
chlupáč	chlupáč
roztomilost	roztomilost
harmonie	harmoni
dvůr	dvůr
don	don
filharmonie	filharmoni
cembalo	cembal
varhany	varhan
plácačka	plácačk
oznámení	oznámení
památník	památník
písemnictví	písemnictví
diplom	diplom
zdravice	zdravic
vyznamenání	vyznamenání
fotografie	fotografi
průvod	průvod
noviny	novin
velikán	velikán
smrt	smrt
anděl	anděl
refektář	refektář
klášter	klášter
hrobeček	hrobeček
originál	originál
nápis	nápis
věčnost	věčnost
konečnost	konečnost
spisovatel	spisovatel
salón	salón
všednost	všednost
čítanka	čítank
kanárek	kanárek
návštěvník	návštěvník
expozice	expozic
stopa	stop
průřez	průřez
ozvěna	ozvěn
zlom	zlom
absurdárium	absurdárium
slavnostnost	slavnostnost
autorka	autork
archív	archív
slavnost	slavnost
převoz	převoz
ostatky	ostatk
linie	lini
svatba	svatb
křtiny	křtin
klasik	klasik
popisek	popisek
fotbalista	fotbalist
výbušnost	výbušnost
ochota	ochot
slávista	slávist
kaiserslautern	kaiserslautern
anketa	anket
výpomoc	výpomoc
ostuda	ostud
defenzíva	defenzív
zákrok	zákrok
tvrdost	tvrdost
svěřenec	svěřenec
čtveřice	čtveřic
rozcvičení	rozcvičení
rozhodčí	rozhodčí
generálka	generálk
policie	polici
začlenění	začlenění
interpol	interpol
kriminálka	kriminálk
návrat	návrat
zasedání	zasedání
ústředna	ústředn
narkotikum	narkotikum
mvčr	mvčr
vyškolení	vyškolení
včlenění	včlenění
poslání	poslání
školství	školství
přání	přání
resort	resort
socialista	socialist
seznam	seznam
archivář	archivář
kolonka	kolonk
příslušnost	příslušnost
agrárník	agrárník
standard	standard
penzum	penzum
školné	školné
přelom	přelom
příval	příval
post	post
krytí	krytí
schodek	schodek
racionalita	racionalit
unie	uni
konkurenceschopnost	konkurenceschopnost
dilema	dilem
složitost	složitost
zub	zub
ustupování	ustupování
vyučování	vyučování
venkov	venkov
primářka	primářk
poliklinika	poliklinik
chlapec	chlapec
dívka	dívk
zóna	zón
kolchoz	kolchoz
onemocnění	onemocnění
žláza	žláz
chudokrevnost	chudokrevnost
ozáření	ozáření
dospělý	dospělý
imunita	imunit
infekce	infekc
ústupek	ústupek
zařazení	zařazení
náboj	náboj
podzim	podzim
kriminalita	kriminalit
nástupce	nástupc
dudek	dudek
voličstvo	voličstv
veterán	veterán
setrvání	setrvání
pohodlí	pohodlí
komentátor	komentátor
mezera	mezer
mistr	mistr
kompromis	kompromis
vyjednavač	vyjednavač
náznak	náznak
popularita	popularit
hlasování	hlasování
zklamání	zklamání
krédo	kréd
odvaha	odvah
dávka	dávk
propuštění	propuštění
bezpečnost	bezpečnost
osadník	osadník
masakr	masakr
modlitba	modlitb
arab	arab
ingerence	ingerenc
znárodňování	znárodňování
chudoba	chudob
bezdomovství	bezdomovství
rovnoprávnost	rovnoprávnost
nutnost	nutnost
křivda	křivd
diskriminace	diskriminac
apartheid	apartheid
desetiletí	desetiletí
elektrifikace	elektrifikac
formulace	formulac
rušení	rušení
reformace	reformac
komunita	komunit
udělování	udělování
zostření	zostření
manifest	manifest
protekce	protekc
usilování	usilování
domovina	domovin
federalizmus	federalizmus
volkstaat	volkstaat
vybírání	vybírání
okupace	okupac
adaptace	adaptac
nesmysl	nesmysl
ohlas	ohlas
stavba	stavb
památka	památk
indolence	indolenc
povšimnutí	povšimnutí
správa	správ
prosazení	prosazení
žralok	žralok
tažení	tažení
pohár	pohár
střela	střel
strůjce	strůjc
výhra	výhr
hvězda	hvězd
siréna	sirén
seriál	seriál
motocykl	motocykl
okruh	okruh
jezdec	jezdec
motocyklista	motocyklist
autodrom	autodrom
ccm	ccm
supersport	supersport
superbike	superbik
lahůdka	lahůdk
tenis	tenis
trio	tri
sudí	sudí
trávník	trávník
dosah	dosah
historie	histori
trumf	trumf
duel	duel
střelec	střelec
marodka	marodk
náhradník	náhradník
kolébka	kolébk
kopaná	kopaná
sezóna	sezón
hlediště	hlediště
žaloba	žalob
bis	bis
redaktor	redaktor
novina	novin
příslušník	příslušník
vyplácení	vyplácení
presumpce	presumpc
nevina	nevin
žalobce	žalobc
vyšetřování	vyšetřování
soudkyně	soudkyně
podklad	podklad
vydavatel	vydavatel
publikování	publikování
představenstvo	představenstv
zůstatek	zůstatek
příkaz	příkaz
obsazení	obsazení
přerušení	přerušení
rozmyšlená	rozmyšlená
jádro	jádr
členství	členství
medaile	medail
znalec	znalec
integrace	integrac
velvyslanec	velvyslanec
mizérie	mizéri
ponorka	ponork
odhodlání	odhodlání
šťáva	šťáv
posádka	posádk
apatie	apati
křižník	křižník
loď	loď
kouč	kouč
jednička	jedničk
povaha	povah
výlet	výlet
přesilovka	přesilovk
oslabení	oslabení
nátura	nátur
tchán	tchán
důraz	důraz
kluziště	kluziště
turnaj	turnaj
pravděpodobnost	pravděpodobnost
kabina	kabin
medvěd	medvěd
vítr	vítr
povstání	povstání
nelibost	nelibost
zatracení	zatracení
audience	audienc
hřích	hřích
zachránkyně	zachránkyně
voj	voj
gloriola	gloriol
rebus	rebus
povstalec	povstalec
brigáda	brigád
rozkaz	rozkaz
státník	státník
epizoda	epizod
prudkost	prudkost
krvavost	krvavost
barikáda	barikád
exil	exil
apetýt	apetýt
přehlídka	přehlídk
aktér	aktér
dohled	dohled
úsloví	úsloví
barikádník	barikádník
loterie	loteri
lotynka	lotynk
hospodaření	hospodaření
odebrání	odebrání
sazka	sazk
výčet	výčet
pasáž	pasáž
výnos	výnos
soupeření	soupeření
pobouření	pobouření
rozjezd	rozjezd
ostřelovač	ostřelovač
unprofor	unprofor
incident	incident
muslim	muslim
porušování	porušování
blokáda	blokád
pašování	pašování
strašidlo	strašidl
rozvinutí	rozvinutí
plutonium	plutonium
uran	uran
protějšek	protějšek
překladiště	překladiště
úlovek	úlovek
cestující	cestující
koordinátor	koordinátor
zprostředkovatel	zprostředkovatel
gram	gram
nález	nález
provokace	provokac
imperialismus	imperialismus
klín	klín
pašerák	pašerák
očerňování	očerňování
podřizování	podřizování
zloděj	zloděj
rozbor	rozbor
úmysl	úmysl
dopad	dopad
zřizování	zřizování
grémium	grémium
lidstvo	lidstv
prostitutka	prostitutk
vlásek	vlásek
beta	bet
faktum	faktum
lázeňství	lázeňství
poukaz	poukaz
mudr	mudr
osvětlení	osvětlení
filmografie	filmografi
komedie	komedi
současník	současník
muzikant	muzikant
kamarád	kamarád
konzervatoř	konzervatoř
chvilka	chvilk
trapnost	trapnost
štěstí	štěstí
fotbal	fotbal
spirála	spirál
předkolo	předkol
konstatování	konstatování
sluníčko	sluníčk
kometa	komet
pohasnutí	pohasnutí
souhvězdí	souhvězdí
juventus	juventus
zvuk	zvuk
reprezentant	reprezentant
připravenost	připravenost
sebevědomí	sebevědomí
propadák	propadák
ohrožení	ohrožení
šok	šok
dvojice	dvojic
brejk	brejk
ovoce	ovoc
kluk	kluk
kondice	kondic
pomocník	pomocník
instruktáž	instruktáž
přátelák	přátelák
remíza	remíz
kořen	kořen
vytáčení	vytáčení
žebříček	žebříček
neochota	neochot
rekonstrukce	rekonstrukc
vlaštovka	vlaštovk
tiskovka	tiskovk
nezdar	nezdar
posilování	posilování
stanovy	stanov
dcera	dcer
holding	holding
racionalizace	racionalizac
trakce	trakc
lokomotivka	lokomotivk
návaznost	návaznost
nakladatelství	nakladatelství
průvodce	průvodc
psychologie	psychologi
profesionál	profesionál
typografie	typografi
odyssea	odysse
příloha	příloh
autobiografie	autobiografi
čaroděj	čaroděj
pozadí	pozadí
ofenziva	ofenziv
slogan	slogan
nápoj	nápoj
soukromí	soukromí
esej	esej
uzdravování	uzdravování
postřeh	postřeh
učebnice	učebnic
stáj	stáj
manželka	manželk
statkář	statkář
převrat	převrat
nádech	nádech
rekonvalescence	rekonvalescenc
úraz	úraz
páteř	páteř
píka	pík
usedlost	usedlost
jatka	jatk
krmení	krmení
prase	pras
čistička	čističk
sušička	sušičk
obilí	obilí
fara	far
střecha	střech
šeď	šeď
rozvalina	rozvalin
ha`hektar	ha`hektar
příbuzný	příbuzný
řepka	řepk
hrách	hrách
vojtěška	vojtěšk
prasnice	prasnic
kanec	kanec
potomek	potomek
stodola	stodol
skot	skot
kráva	kráv
vepřové	vepřové
býk	býk
hnůj	hnůj
živina	živin
příbuzenstvo	příbuzenstv
bratranec	bratranec
přílep	přílep
zemědělec	zemědělec
maso	mas
záložna	záložn
koníček	koníček
řehole	řehol
příklad	příklad
verva	verv
sedlačení	sedlačení
dřina	dřin
chov	chov
plnokrevník	plnokrevník
vnuk	vnuk
grunt	grunt
zaměstnanost	zaměstnanost
vzorek	vzorek
respondent	respondent
snižování	snižování
handlíř	handlíř
rukoudání	rukoudání
žitná	žitná
mramor	mramor
etika	etik
čest	čest
tržiště	tržiště
konsorcium	konsorcium
blázen	blázen
ironie	ironi
podfuk	podfuk
reálsocialismus	reálsocialismus
občánek	občánek
rakev	rakev
statečnost	statečnost
chůva	chův
bůh	bůh
úmluva	úmluv
bankéř	bankéř
fenomén	fenomén
skepse	skeps
gen	gen
soda	sod
pořad	pořad
repríza	repríz
portrét	portrét
svědectví	svědectví
schéma	schém
předvídatelnost	předvídatelnost
ekologie	ekologi
teze	tez
znak	znak
soudnost	soudnost
roztržka	roztržk
správnost	správnost
ekolog	ekolog
sebevražda	sebevražd
kysličník	kysličník
sedačka	sedačk
zavinění	zavinění
elektronika	elektronik
kapota	kapot
spínač	spínač
kůže	kůž
atletika	atletik
tyč	tyč
dálka	dálk
disk	disk
překážka	překážk
oštěp	oštěp
maraton	maraton
mítink	mítink
kanoistika	kanoistik
kanoista	kanoist
slalom	slalom
lyžování	lyžování
skok	skok
lyže	lyž
jízda	jízd
porto	port
autonehoda	autonehod
spolujezdec	spolujezdec
dálnice	dálnic
převrácení	převrácení
spolucestující	spolucestující
chalupa	chalup
oslava	oslav
disent	disent
lidovka	lidovk
odkup	odkup
operátorka	operátork
rms	rms
vyřizování	vyřizování
zadání	zadání
háček	háček
obchodník	obchodník
provize	proviz
vyrovnanost	vyrovnanost
preambule	preambul
prosazování	prosazování
psychiatr	psychiatr
rozložení	rozložení
propaganda	propagand
pošetilost	pošetilost
zakotvení	zakotvení
komentář	komentář
poznámka	poznámk
radnice	radnic
holobyt	holobyt
dlužník	dlužník
rozloha	rozloh
podlaha	podlah
okenice	okenic
zárubeň	zárubeň
zázemí	zázemí
umývárna	umývárn
ing	ing
vystěhování	vystěhování
pohledávka	pohledávk
ambice	ambic
rozepře	rozepř
pilíř	pilíř
populace	populac
porodnost	porodnost
demograf	demograf
odpočinek	odpočinek
tvůrce	tvůrc
balvan	balvan
konstrukce	konstrukc
spěch	spěch
opomenutí	opomenutí
pojistné	pojistné
únosnost	únosnost
diferenciace	diferenciac
příklon	příklon
rozlišení	rozlišení
penze	penz
referendum	referendum
vkladatel	vkladatel
konání	konání
revize	reviz
transplantace	transplantac
hlídka	hlídk
poprava	poprav
vykonání	vykonání
střelnice	střelnic
publicista	publicist
podezření	podezření
žurnalista	žurnalist
zaklínadlo	zaklínadl
odstoupení	odstoupení
deprese	depres
náčelník	náčelník
štáb	štáb
hračka	hračk
dědeček	dědeček
pozor	pozor
paluba	palub
viník	viník
spolupachatel	spolupachatel
pistolník	pistolník
obžaloba	obžalob
uklouznutí	uklouznutí
prezidentová	prezidentová
upřímnost	upřímnost
schod	schod
pivo	piv
salto	salt
kladina	kladin
tušení	tušení
náplň	náplň
odbor	odbor
královna	královn
láhev	láhev
skotská	skotská
obvinění	obvinění
kleptoman	kleptoman
generál	generál
střelivo	střeliv
klíč	klíč
záhada	záhad
ruinování	ruinování
klam	klam
výpadovka	výpadovk
premiéra	premiér
zábava	zábav
dramatizace	dramatizac
román	román
režie	reži
režisér	režisér
repertoár	repertoár
inscenace	inscenac
kašpar	kašpar
doňa	doň
předpremiéra	předpremiér
rokoko	rokok
show	show
story	stor
dramaturg	dramaturg
herec	herec
fraška	frašk
letora	letor
jeviště	jeviště
sluha	sluh
činohra	činohr
odpuštění	odpuštění
vulgarita	vulgarit
triviálnost	triviálnost
studio	studi
razance	razanc
žargon	žargon
knoflík	knoflík
kov	kov
oživení	oživení
ruda	rud
ocelář	ocelář
hliník	hliník
nadprodukce	nadprodukc
olovo	olov
obměna	obměn
autobaterie	autobateri
měď	měď
zinek	zinek
vyrovnání	vyrovnání
cín	cín
nikl	nikl
světlo	světl
mangan	mangan
ocelářství	ocelářství
wolfram	wolfram
shoda	shod
kondička	kondičk
potlesk	potlesk
sekera	seker
životospráva	životospráv
kůň	kůň
prostituce	prostituc
ubytovna	ubytovn
mládež	mládež
pohoršení	pohoršení
pokuta	pokut
řemeslo	řemesl
odrazování	odrazování
trestání	trestání
grant	grant
vzdělávání	vzdělávání
vývozce	vývozc
cigareta	cigaret
margarín	margarín
cukrovinka	cukrovink
sýr	sýr
čokoláda	čokolád
lihovina	lihovin
přirážka	přirážk
ecu	ecu
zúčtování	zúčtování
certifikace	certifikac
znepokojení	znepokojení
uznávání	uznávání
inspekce	inspekc
udělení	udělení
vyřízení	vyřízení
pololetí	pololetí
exportér	exportér
mléko	mlék
máslo	másl
drůbež	drůbež
tis	tis
příměří	příměří
závislost	závislost
labourista	labourist
republikán	republikán
stažení	stažení
kontingent	kontingent
unionista	unionist
duše	duš
ďábel	ďábel
potrat	potrat
primář	primář
gynekologie	gynekologi
interrupce	interrupc
polka	polk
provádění	provádění
úplata	úplat
občanka	občank
prohlídka	prohlídk
tkáň	tkáň
výpověď	výpověď
vynesení	vynesení
rozsudek	rozsudek
odškodnění	odškodnění
perzekuce	perzekuc
sekretariát	sekretariát
vdova	vdov
vdovec	vdovec
věznění	věznění
hanobitel	hanobitel
síň	síň
líčení	líčení
hanobení	hanobení
rasa	ras
přesvědčení	přesvědčení
schvalování	schvalování
teror	teror
katolík	katolík
fašista	fašist
posudek	posudek
choroba	chorob
nebezpečnost	nebezpečnost
vztahovačnost	vztahovačnost
fanatismus	fanatismus
figurína	figurín
fašismus	fašismus
komunismus	komunismus
řeč	řeč
invektiva	invektiv
poledne	poledn
zástupkyně	zástupkyně
jmění	jmění
úpis	úpis
ážio	áži
emise	emis
doručitel	doručitel
bankovnictví	bankovnictví
upisování	upisování
konfederace	konfederac
terorista	terorist
arzenál	arzenál
skrýš	skrýš
vrátka	vrátk
výbušnina	výbušnin
bunkr	bunkr
vyhlášení	vyhlášení
minomet	minomet
samopal	samopal
kalašnikov	kalašnikov
revolver	revolver
rozpoutání	rozpoutání
plukovník	plukovník
bezpečí	bezpečí
finančník	finančník
čtvrtstoletí	čtvrtstoletí
krveprolévání	krveprolévání
užitečnost	užitečnost
čtyřka	čtyřk
sochař	sochař
akademie	akademi
zakladatel	zakladatel
sympózium	sympózium
žula	žul
syenit	syenit
vidění	vidění
recenze	recenz
kontrapunkt	kontrapunkt
flétna	flétn
klarinet	klarinet
playback	playback
poslech	poslech
hodiny	hodin
směřování	směřování
part	part
homogenita	homogenit
členitost	členitost
marimba	marimb
zvonkohra	zvonkohr
soustava	soustav
ornament	ornament
tah	tah
štětec	štětec
poznání	poznání
sekce	sekc
průchod	průchod
emocionalita	emocionalit
nános	nános
brožura	brožur
snídaně	snídaně
šampion	šampion
spáč	spáč
provizórium	provizórium
zrada	zrad
hroch	hroch
pouť	pouť
blbost	blbost
manekýn	manekýn
piano	pian
variation	variation
music	music
instrument	instrument
edice	edic
oštěpař	oštěpař
rekordman	rekordman
triumf	triumf
suverenita	suverenit
cihla	cihl
cm`centimetr	cm`centimetr
překážkář	překážkář
mistryně	mistryně
vítězka	vítězk
rekord	rekord
sprint	sprint
hod	hod
basketbal	basketbal
spoluzakladatel	spoluzakladatel
odhalení	odhalení
pomník	pomník
hvězdárna	hvězdárn
socha	soch
pedagog	pedagog
radost	radost
nabývání	nabývání
vědomost	vědomost
psycholog	psycholog
pokyn	pokyn
známkování	známkování
humanizace	humanizac
učivo	učiv
úvazek	úvazek
založení	založení
boom	boom
převedení	převedení
rezort	rezort
předchůdce	předchůdc
věrozvěst	věrozvěst
dietář	dietář
ema	em
dieta	diet
agrosalon	agrosalon
živitelka	živitelk
vyznačení	vyznačení
plod	plod
oříšek	oříšek
mandle	mandl
kokos	kokos
kešu	kešu
koření	koření
pěstitel	pěstitel
vagonka	vagonk
minihuť	minihuť
zlomek	zlomek
pvc	pvc
polyvinylchlorid	polyvinylchlorid
etylen	etylen
rozpaky	rozpak
vyváženost	vyváženost
žití	žití
odčerpávání	odčerpávání
zastánce	zastánc
realita	realit
stezka	stezk
cyklista	cyklist
kolaudace	kolaudac
způsobilost	způsobilost
facto	fact
výstaviště	výstaviště
devastace	devastac
vyjíždění	vyjíždění
galaxie	galaxi
režim	režim
přestavba	přestavb
zastupitelstvo	zastupitelstv
lupič	lupič
turista	turist
náramek	náramek
hodinky	hodink
násilník	násilník
parťák	parťák
vězeňství	vězeňství
trestanec	trestanec
odpadek	odpadek
individuum	individuum
pachatel	pachatel
afekt	afekt
zatmění	zatmění
resocializace	resocializac
výdělek	výdělek
muklotechna	muklotechn
tužka	tužk
přísun	přísun
zamyšlení	zamyšlení
stanoviště	stanoviště
budování	budování
srdce	srdc
režisérka	režisérk
obzor	obzor
plátno	plátn
trumpetista	trumpetist
kvinteto	kvintet
sextet	sextet
individualita	individualit
prarodič	prarodič
improvizace	improvizac
kvintet	kvintet
stylistika	stylistik
trubka	trubk
křídlovka	křídlovk
tenor	tenor
sopránsaxofonista	sopránsaxofonist
klavírista	klavírist
bigband	bigband
znovuobnovení	znovuobnovení
měsíčník	měsíčník
beat	beat
hvězdička	hvězdičk
filmař	filmař
tajemnice	tajemnic
infarkt	infarkt
hradiště	hradiště
odbornost	odbornost
prvotina	prvotin
protagonista	protagonist
cinema	cinem
autenticita	autenticit
kritičnost	kritičnost
natáčení	natáčení
kameraman	kameraman
podobenství	podobenství
šikanování	šikanování
revolta	revolt
freska	fresk
zkostnatělost	zkostnatělost
civilizace	civilizac
věda	věd
postava	postav
podání	podání
rezervovanost	rezervovanost
nabubřelost	nabubřelost
mister	mister
uvedení	uvedení
ukázka	ukázk
kinematografie	kinematografi
rukopis	rukopis
komerce	komerc
kladení	kladení
odveta	odvet
superpohár	superpohár
expedice	expedic
osmitisícovka	osmitisícovk
shánění	shánění
víkend	víkend
skála	skál
paraglidista	paraglidist
létání	létání
padák	padák
batoh	batoh
sedmitisícovka	sedmitisícovk
stěna	stěn
prvovýstup	prvovýstup
lezec	lezec
aklimatizace	aklimatizac
osma	osm
sedlo	sedl
fix	fix
dalekohled	dalekohled
sklon	sklon
spodek	spodek
mix	mix
vršek	vršek
organizátor	organizátor
objednání	objednání
jídlo	jídl
oběd	oběd
večeře	večeř
čaj	čaj
kafe	kaf
konto	kont
specialita	specialit
var	var
čokoládička	čokoládičk
trošička	trošičk
borec	borec
intimita	intimit
horolezectví	horolezectví
trekking	trekking
kontrakt	kontrakt
kuřák	kuřák
zlozvyk	zlozvyk
motorismus	motorismus
držení	držení
vlastnění	vlastnění
ziskovost	ziskovost
portfolio	portfoli
zástava	zástav
stromek	stromek
porost	porost
dříví	dříví
ošetřování	ošetřování
výchova	výchov
mýcení	mýcení
kalamita	kalamit
zlevňování	zlevňování
přetlak	přetlak
řezivo	řeziv
zpestření	zpestření
sázení	sázení
ožínání	ožínání
škůdce	škůdc
prořezávka	prořezávk
správce	správc
pojistka	pojistk
požár	požár
popel	popel
uhrazení	uhrazení
spořitelna	spořiteln
merkur	merkur
výbojka	výbojk
žárovka	žárovk
autožárovka	autožárovk
svítidlo	svítidl
přepočet	přepočet
měna	měn
deficit	deficit
tranzit	tranzit
plyn	plyn
voršilka	voršilk
určení	určení
kongregace	kongregac
přidělení	přidělení
zablokování	zablokování
výpis	výpis
složenka	složenk
interpelace	interpelac
popud	popud
nákladnost	nákladnost
kriminalista	kriminalist
uvalení	uvalení
zatykač	zatykač
vydírání	vydírání
krk	krk
videokamera	videokamer
mladík	mladík
policista	policist
okrsek	okrsek
odnětí	odnětí
podjatost	podjatost
zadržení	zadržení
půlnoc	půlnoc
deklarace	deklarac
rozhodnost	rozhodnost
trpělivost	trpělivost
relace	relac
funkcionář	funkcionář
přizvání	přizvání
establishment	establishment
loajalista	loajalist
agresor	agresor
svatozář	svatozář
mučedník	mučedník
skupinka	skupink
trikolóra	trikolór
protestant	protestant
vraždění	vraždění
přívrženec	přívrženec
spása	spás
kolonie	koloni
stoupenec	stoupenec
dozor	dozor
úterý	úterý
svržení	svržení
galerie	galeri
informatička	informatičk
hmp	hmp
dovednost	dovednost
diplomat	diplomat
obratnost	obratnost
vědec	vědec
uvažování	uvažování
muzeum	muzeum
podobnost	podobnost
sklonek	sklonek
pánbůh	pánbůh
stolec	stolec
souřadnice	souřadnic
příbuzná	příbuzná
oceán	oceán
gentleman	gentleman
honba	honb
povzdech	povzdech
opora	opor
lodivod	lodivod
náhled	náhled
bytost	bytost
autorita	autorit
mání	mání
makléř	makléř
lavice	lavic
parket	parket
sólo	sól
index	index
dluhopis	dluhopis
seance	seanc
závěs	závěs
zpevnění	zpevnění
premiant	premiant
len	len
obligace	obligac
losování	losování
zápisník	zápisník
šéfredaktor	šéfredaktor
notářka	notářk
opatrování	opatrování
navrácení	navrácení
jurisdikce	jurisdikc
emigrantka	emigrantk
přemístění	přemístění
únos	únos
advokát	advokát
potaz	potaz
t`tuna	t`tun
čerpadlo	čerpadl
nafta	naft
haléř	haléř
kanalizace	kanalizac
magistrát	magistrát
odvádění	odvádění
čištění	čištění
čistírna	čistírn
přípojka	přípojk
rybník	rybník
nádrž	nádrž
jez	jez
financování	financování
stočné	stočné
vyřešení	vyřešení
intenzifikace	intenzifikac
rozbití	rozbití
lahev	lahev
šampaňské	šampaňské
ropovod	ropovod
rafinerie	rafineri
družba	družb
tělocvik	tělocvik
míč	míč
koš	koš
jedinec	jedinec
rozvodovost	rozvodovost
stagnace	stagnac
manželství	manželství
moratorium	moratorium
rozluka	rozluk
selhání	selhání
kontext	kontext
herečka	herečk
samoživitelka	samoživitelk
nepravda	nepravd
vybíjení	vybíjení
stádo	stád
zdražování	zdražování
éra	ér
nadstav	nadstav
přizpůsobování	přizpůsobování
dobytek	dobytek
nadvýroba	nadvýrob
demagogie	demagogi
řezník	řezník
masokombinát	masokombinát
zlevnění	zlevnění
terorizmus	terorizmus
erupce	erupc
středomoří	středomoří
nestabilita	nestabilit
kostka	kostk
ozbrojenec	ozbrojenec
vražda	vražd
přepad	přepad
odpor	odpor
království	království
doktrína	doktrín
král	král
extremizmus	extremizmus
deformace	deformac
islám	islám
fundamentalizmus	fundamentalizmus
šajch	šajch
vězení	vězení
fundamentalista	fundamentalist
urážka	urážk
sok	sok
monarchie	monarchi
napětí	napětí
radikál	radikál
aktivista	aktivist
represe	repres
ilegalita	ilegalit
nervozita	nervozit
mučení	mučení
náboženství	náboženství
krajnice	krajnic
pozvání	pozvání
zdrženlivost	zdrženlivost
aliance	alianc
vyjednávání	vyjednávání
maratonec	maratonec
maratón	maratón
reportér	reportér
rocker	rocker
bigbít	bigbít
výtržnost	výtržnost
fáma	fám
kuchař	kuchař
milovník	milovník
fotodokumentace	fotodokumentac
provaz	provaz
rukavice	rukavic
ohledávač	ohledávač
kmen	kmen
větev	větev
bytovka	bytovk
pohřeb	pohřeb
sedativum	sedativum
holčička	holčičk
hospoda	hospod
kotlina	kotlin
kapelník	kapelník
restaurace	restaurac
parta	part
holka	holk
mafie	mafi
věřitel	věřitel
dcerka	dcerk
škodovka	škodovk
taška	tašk
listina	listin
razítko	razítk
vyhrožování	vyhrožování
výsměch	výsměch
rozloučená	rozloučená
upřednostňování	upřednostňování
zakomponování	zakomponování
studie	studi
zdržení	zdržení
tisícovka	tisícovk
brzda	brzd
purkrabství	purkrabství
míčovna	míčovn
archa	arch
legenda	legend
hostování	hostování
těleso	těles
přednáška	přednášk
psychoanalýza	psychoanalýz
egyptologie	egyptologi
kolokvium	kolokvium
básník	básník
euforie	eufori
rusalka	rusalk
komplet	komplet
pastorkyně	pastorkyně
okouzlení	okouzlení
libreto	libret
poetika	poetik
jakobín	jakobín
čert	čert
zpěv	zpěv
gazela	gazel
diskofil	diskofil
pěvectví	pěvectví
sopranistka	sopranistk
jubileum	jubileum
svěžest	svěžest
parketa	parket
intrikán	intrikán
pěvec	pěvec
poustevník	poustevník
počin	počin
přispění	přispění
poměry	poměr
partie	parti
sonornost	sonornost
společník	společník
jednatel	jednatel
posouzení	posouzení
sloučení	sloučení
mravnost	mravnost
zřetel	zřetel
obohacení	obohacení
snílek	snílek
obdiv	obdiv
vzdor	vzdor
odvolání	odvolání
karmelitán	karmelitán
útulek	útulek
chrám	chrám
jezulátko	jezulátk
mše	mš
superliga	superlig
basketbalista	basketbalist
tráva	tráv
zpravodajka	zpravodajk
tenista	tenist
kurt	kurt
šampionka	šampionk
dvorec	dvorec
hráčka	hráčk
krajanka	krajank
rivalita	rivalit
bordel	bordel
debl	debl
bojovnost	bojovnost
střetnutí	střetnutí
set	set
přemožitelka	přemožitelk
sňatek	sňatek
bázeň	bázeň
soupeřka	soupeřk
křeč	křeč
migréna	migrén
houževnatost	houževnatost
nástraha	nástrah
lóže	lóž
dáma	dám
diplomacie	diplomaci
plotýnka	plotýnk
konev	konev
kytka	kytk
svah	svah
zákrut	zákrut
ves	ves
objetí	objetí
dvorek	dvorek
advisor	advisor
president	president
poradkyně	poradkyně
dveře	dveř
krása	krás
střídání	střídání
zabarvení	zabarvení
motiv	motiv
titulek	titulek
požehnání	požehnání
xerox	xerox
komunizmus	komunizmus
cinkání	cinkání
profesorka	profesork
formát	formát
pohlednice	pohlednic
žert	žert
maminka	mamink
pohádka	pohádk
red	red
cihelna	ciheln
azyl	azyl
politologie	politologi
občanství	občanství
téze	téz
obdoba	obdob
sousloví	sousloví
traveller	traveller
elévka	elévk
promoce	promoc
reportérka	reportérk
kariéra	kariér
novinářka	novinářk
odbory	odbor
dvojče	dvojč
pobřeží	pobřeží
doktorát	doktorát
spleť	spleť
sbírání	sbírání
psaní	psaní
teorie	teori
pomezí	pomezí
spolukandidátka	spolukandidátk
viceprezident	viceprezident
prezidentka	prezidentk
hypotéza	hypotéz
chaos	chaos
kategorizace	kategorizac
fungování	fungování
rezoluce	rezoluc
invaze	invaz
means	means
záliv	záliv
diktátor	diktátor
krev	krev
memento	mement
stoupenkyně	stoupenkyně
strážce	strážc
smysl	smysl
instrukce	instrukc
stáž	stáž
táta	tát
planeta	planet
tlupa	tlup
kobylka	kobylk
hlídač	hlídač
rvačka	rvačk
rolník	rolník
četník	četník
hasič	hasič
pouto	pout
štvaní	štvaní
hadry	hadr
nešťastník	nešťastník
sutina	sutin
stotisíc	stotisíc
beznadějnost	beznadějnost
hrůza	hrůz
klika	klik
hazardér	hazardér
podněcovatel	podněcovatel
zkáza	zkáz
palič	palič
angažovanost	angažovanost
ozdravění	ozdravění
masmédium	masmédium
symptom	symptom
glasnost	glasnost
věta	vět
řádek	řádek
předák	předák
kibuc	kibuc
výšina	výšin
próza	próz
skříňka	skříňk
výtisk	výtisk
knihkupec	knihkupec
veletrh	veletrh
odpůrce	odpůrc
poučka	poučk
keynesianizmus	keynesianizmus
kodifikace	kodifikac
ortodoxie	ortodoxi
sebejistota	sebejistot
konjunktura	konjunktur
oktáva	oktáv
ucho	uch
dolaďování	dolaďování
duch	duch
krácení	krácení
labilita	labilit
utrácení	utrácení
rétorika	rétorik
hdp	hdp
antipod	antipod
dogma	dogm
omylnost	omylnost
papež	papež
derby	derb
podívaná	podívaná
závodiště	závodiště
klusák	klusák
kvalifikace	kvalifikac
peloton	peloton
náskok	náskok
sulka	sulk
skóre	skór
penalta	penalt
lesk	lesk
vyvrcholení	vyvrcholení
sraz	sraz
stoper	stoper
klobouk	klobouk
žebrák	žebrák
minikrámek	minikrámek
zpívání	zpívání
písnička	písničk
umělec	umělec
výtvarník	výtvarník
přiznání	přiznání
regulérnost	regulérnost
upřesnění	upřesnění
obnova	obnov
přihlédnutí	přihlédnutí
dokončení	dokončení
dokumentace	dokumentac
památkář	památkář
repase	repas
zhotovitel	zhotovitel
vyhodnocení	vyhodnocení
výhodnost	výhodnost
bezstarostnost	bezstarostnost
stavebník	stavebník
úkon	úkon
náhražka	náhražk
motorista	motorist
příčka	příčk
podvozek	podvozek
peněženka	peněženk
trhák	trhák
leasing	leasing
koeficient	koeficient
akontace	akontac
splátka	splátk
pochopení	pochopení
repro	repr
kandidátka	kandidátk
lídr	lídr
prokurátor	prokurátor
frakce	frakc
zmocněnec	zmocněnec
izolacionizmus	izolacionizmus
přestěhování	přestěhování
rádio	rádi
izolacionista	izolacionist
zvrat	zvrat
kasárna	kasárn
hymna	hymn
badatel	badatel
přiblížení	přiblížení
person	person
matador	matador
sebedůvěra	sebedůvěr
prvenství	prvenství
záminka	zámink
komfort	komfort
automat	automat
kouř	kouř
pěna	pěn
hon	hon
sako	sak
párky	párk
předkrm	předkrm
zděšení	zděšení
vyprávění	vyprávění
pragobanka	pragobank
rezervování	rezervování
vycvičení	vycvičení
časoměřič	časoměřič
izvestije	izvestij
účastnice	účastnic
sluchátko	sluchátk
infrastruktura	infrastruktur
přebytek	přebytek
zásluha	zásluh
sestavení	sestavení
strážník	strážník
stříkačka	stříkačk
roztok	roztok
mlýn	mlýn
balírna	balírn
pokrm	pokrm
atest	atest
brožurka	brožurk
publikace	publikac
vaření	vaření
lágr	lágr
zmírnění	zmírnění
utrpení	utrpení
reparace	reparac
zkratka	zkratk
beg	beg
brug	brug
nacizmus	nacizmus
bojovník	bojovník
uzavírání	uzavírání
penzión	penzión
schválení	schválení
odboj	odboj
směna	směn
koncentrák	koncentrák
sabotáž	sabotáž
mlynář	mlynář
mouka	mouk
syčák	syčák
zaznamenávání	zaznamenávání
přestupek	přestupek
delikt	delikt
říše	říš
memorandum	memorandum
klaun	klaun
dostání	dostání
keramik	keramik
historik	historik
galerista	galerist
labyrint	labyrint
katedra	katedr
design	design
scenárista	scenárist
náčrtek	náčrtek
návrhář	návrhář
kostým	kostým
půvab	půvab
špička	špičk
mrtvice	mrtvic
civilista	civilist
vytržení	vytržení
lazaret	lazaret
sál	sál
legrace	legrac
bitva	bitv
rovnoběžka	rovnoběžk
miniatura	miniatur
hrdina	hrdin
vlast	vlast
martini	martini
sestřička	sestřičk
tupost	tupost
byrokracie	byrokraci
nesmyslnost	nesmyslnost
zabíjení	zabíjení
rival	rival
scénář	scénář
omezenost	omezenost
černoch	černoch
černo	čern
homosexuál	homosexuál
snášenlivost	snášenlivost
kněz	kněz
rabín	rabín
miminko	mimink
proslov	proslov
diskařka	diskařk
moč	moč
steroid	steroid
nandrolon	nandrolon
vrhačka	vrhačk
tělo	těl
ampulka	ampulk
zjištění	zjištění
vitamín	vitamín
aplikace	aplikac
doping	doping
předplatitel	předplatitel
předplatné	předplatné
zaslání	zaslání
kompenzace	kompenzac
distribuce	distribuc
povrch	povrch
vedro	vedr
skluz	skluz
překročení	překročení
práh	práh
vizitka	vizitk
extraliga	extralig
zps	zps
údernost	údernost
stávka	stávk
energetika	energetik
elektrárna	elektrárn
uzávěrka	uzávěrk
přezkoumání	přezkoumání
pasívum	pasívum
likvidátor	likvidátor
penále	penál
dobytnost	dobytnost
politování	politování
sudička	sudičk
imperializmus	imperializmus
příbor	příbor
chřest	chřest
lžíce	lžíc
kaše	kaš
houf	houf
slepenec	slepenec
noha	noh
elita	elit
nedočkavec	nedočkavec
hradba	hradb
nádvoří	nádvoří
občanstvo	občanstv
eurocard	eurocard
výsada	výsad
příplatek	příplatek
studna	studn
uskupení	uskupení
levice	levic
předobraz	předobraz
ostraha	ostrah
trouba	troub
cela	cel
parcela	parcel
folklor	folklor
víno	vín
neexistence	neexistenc
nerealizace	nerealizac
převis	převis
chata	chat
chatka	chatk
vinohrad	vinohrad
hostinec	hostinec
rozpětí	rozpětí
asociace	asociac
udržování	udržování
paroplavba	paroplavb
spoj	spoj
junta	junt
demise	demis
guvernér	guvernér
manipulace	manipulac
embargo	embarg
vlajka	vlajk
jackpot	jackpot
band	band
lucerna	lucern
melodie	melodi
vokál	vokál
katarze	katarz
předkapela	předkapel
šleh	šleh
rap	rap
rytmika	rytmik
rock	rock
hop	hop
předehra	předehr
využívání	využívání
flétnistka	flétnistk
dárek	dárek
předskokanka	předskokank
písničkářka	písničkářk
stáří	stáří
dožití	dožití
odbytné	odbytné
kousek	kousek
maximum	maximum
úroda	úrod
aukce	aukc
pavilon	pavilon
primátor	primátor
rezervace	rezervac
skvost	skvost
průtah	průtah
členka	členk
prevence	prevenc
přednosta	přednost
podávání	podávání
jev	jev
znovuzačlenění	znovuzačlenění
civil	civil
brašna	brašn
maskáče	maskáč
kanada	kanad
pytel	pytel
vycházka	vycházk
přihláška	přihlášk
tisíciletí	tisíciletí
vyzrálost	vyzrálost
podbřišek	podbřišek
sebeurčení	sebeurčení
vynález	vynález
velmoc	velmoc
úhel	úhel
děj	děj
supervelmoc	supervelmoc
obětina	obětin
vzdání	vzdání
grimasa	grimas
podtext	podtext
štěnice	štěnic
skrupule	skrupul
mikrofon	mikrofon
vyznání	vyznání
přenos	přenos
eso	es
mariáš	mariáš
reál	reál
podvod	podvod
semínko	semínk
málo	mál
protikandidát	protikandidát
adept	adept
přízeň	přízeň
výrok	výrok
blahobyt	blahobyt
nahlodání	nahlodání
víra	vír
němota	němot
zátiší	zátiší
bohemista	bohemist
překladatel	překladatel
monografie	monografi
tlumočník	tlumočník
avantgarda	avantgard
verš	verš
střih	střih
medailón	medailón
múza	múz
vyjadřování	vyjadřování
četba	četb
ambasáda	ambasád
oběh	oběh
myšlení	myšlení
ohnisko	ohnisk
drama	dram
akumulace	akumulac
výboj	výboj
emigrant	emigrant
mládí	mládí
literát	literát
filozof	filozof
intelektuál	intelektuál
nacionalizmus	nacionalizmus
vyvolenost	vyvolenost
jedinečnost	jedinečnost
kohorta	kohort
idol	idol
nadvláda	nadvlád
kabuki	kabuki
trezor	trezor
zázrak	zázrak
volejbalistka	volejbalistk
mora	mor
předzvěst	předzvěst
děvče	děvč
mečbol	mečbol
domovník	domovník
nájemník	nájemník
atrakce	atrakc
zádrhel	zádrhel
retrospektiva	retrospektiv
pocta	poct
absence	absenc
poctivost	poctivost
osvěžení	osvěžení
příběh	příběh
lidičky	lidičk
všednodennost	všednodennost
nadsázka	nadsázk
úděl	úděl
hrabal	hrabal
chur	chur
sníh	sníh
romance	romanc
slunce	slunc
kolekce	kolekc
drobnokresba	drobnokresb
bar	bar
poušť	poušť
cíp	cíp
vinice	vinic
polévka	polévk
sborník	sborník
hrabě	hrabě
slovenština	slovenštin
lektorát	lektorát
ukrajinština	ukrajinštin
rusínština	rusínštin
slavista	slavist
germanista	germanist
vlak	vlak
osmdesátiny	osmdesátin
výstavka	výstavk
maďarština	maďarštin
antikvariát	antikvariát
cithara	cithar
kostel	kostel
poutník	poutník
zvláštnost	zvláštnost
liturgie	liturgi
romština	romštin
videokazeta	videokazet
exotika	exotik
zrcadlo	zrcadl
hírlap	hírlap
stať	stať
hungarista	hungarist
obdivování	obdivování
nezájem	nezájem
sblížení	sblížení
propojení	propojení
koridor	koridor
severozápad	severozápad
proklamace	proklamac
naléhavost	naléhavost
přeložení	přeložení
středohoří	středohoří
chko	chk
posun	posun
přeložka	přeložk
profil	profil
znečištění	znečištění
ovzduší	ovzduší
oxid	oxid
dusík	dusík
aerosol	aerosol
náročnost	náročnost
trojúhelník	trojúhelník
neštěstí	neštěstí
uplatňování	uplatňování
registrace	registrac
vzmach	vzmach
reaktor	reaktor
zhroucení	zhroucení
rána	rán
otěž	otěž
zranitelnost	zranitelnost
stratég	stratég
rezignace	rezignac
adresnost	adresnost
přídavek	přídavek
násobek	násobek
uváženost	uváženost
tunel	tunel
tubus	tubus
zatížení	zatížení
nábřeží	nábřeží
špalek	špalek
šetření	šetření
zhoupnutí	zhoupnutí
prezentace	prezentac
ústa	úst
posel	posel
naslouchání	naslouchání
teoretik	teoretik
ovečka	ovečk
písek	písek
skluzavka	skluzavk
exekutiva	exekutiv
poslankyně	poslankyně
kuča	kuč
experiment	experiment
zkrácení	zkrácení
bit	bit
terminál	terminál
pasažér	pasažér
chuligán	chuligán
letec	letec
šlehačka	šlehačk
dort	dort
poloprivatizace	poloprivatizac
atestace	atestac
vytížení	vytížení
zruinování	zruinování
loajalita	loajalit
džungle	džungl
vize	viz
přepis	přepis
povyk	povyk
báseň	báseň
roving	roving
tančírna	tančírn
sekvence	sekvenc
night	night
soundtrack	soundtrack
orchestrace	orchestrac
patos	patos
vyznění	vyznění
oddanost	oddanost
smyčec	smyčec
žesť	žesť
tympány	tympán
předurčenost	předurčenost
creation	creation
death	death
sea	se
ice	ic
dvojakost	dvojakost
monstrum	monstrum
něžnost	něžnost
zuřivost	zuřivost
terorismus	terorismus
břeh	břeh
uvěznění	uvěznění
justice	justic
hovado	hovad
éter	éter
frekvence	frekvenc
poslechovost	poslechovost
návratnost	návratnost
neprospěch	neprospěch
slyšení	slyšení
country	countr
koláč	koláč
kompetentnost	kompetentnost
objektivnost	objektivnost
uvážlivost	uvážlivost
citlivost	citlivost
metro	metr
kolektor	kolektor
mode	mod
atm	atm
videosignál	videosignál
megabit	megabit
obrazovka	obrazovk
monitoring	monitoring
oprávněnost	oprávněnost
autogramiáda	autogramiád
knihkupectví	knihkupectví
dvojblok	dvojblok
pochodeň	pochodeň
štafeta	štafet
míle	míl
vandal	vandal
bití	bití
hůl	hůl
vandalství	vandalství
úder	úder
zadnice	zadnic
jizva	jizv
límeček	límeček
zpronevěra	zpronevěr
kulturkampf	kulturkampf
vlastenec	vlastenec
kníže	kníž
loutkohra	loutkohr
rozum	rozum
mámení	mámení
emancipace	emancipac
ideologie	ideologi
aristokracie	aristokraci
nacionalismus	nacionalismus
rozumnost	rozumnost
děd	děd
katechismus	katechismus
pec	pec
sobeckost	sobeckost
jednotlivec	jednotlivec
mytologie	mytologi
rod	rod
odsun	odsun
sebeidentifikace	sebeidentifikac
opakování	opakování
halas	halas
balast	balast
cvikr	cvikr
truchlohra	truchlohr
pohrobek	pohrobek
zřeknutí	zřeknutí
vyslechnutí	vyslechnutí
nesouhlas	nesouhlas
porušení	porušení
zastupitelství	zastupitelství
podnět	podnět
brýle	brýl
dřevina	dřevin
obroučka	obroučk
roh	roh
buvol	buvol
hedvábí	hedvábí
čočka	čočk
kuriozitka	kuriozitk
optika	optik
optik	optik
obruba	obrub
společenstvo	společenstv
dívání	dívání
kozačka	kozačk
obličej	obličej
luxus	luxus
obliba	oblib
oděr	oděr
dioptrie	dioptri
záření	záření
nos	nos
nošení	nošení
zajímavost	zajímavost
designer	designer
odstín	odstín
titan	titan
alergie	alergi
sborná	sborná
sovět	sovět
podprůměr	podprůměr
supermalčik	supermalčik
zlomenina	zlomenin
pláň	pláň
tribuna	tribun
aplaus	aplaus
demonstrant	demonstrant
skandování	skandování
prokop	prokop
taxikář	taxikář
nehoda	nehod
hrobka	hrobk
patriarcha	patriarch
nedopatření	nedopatření
letopočet	letopočet
demonstrace	demonstrac
házení	házení
pneumatika	pneumatik
tryzna	tryzn
hrob	hrob
šiřitel	šiřitel
atentát	atentát
krveprolití	krveprolití
pomsta	pomst
příhoda	příhod
zlomení	zlomení
jmenovatel	jmenovatel
uzel	uzel
odštěpení	odštěpení
kongresman	kongresman
navýšení	navýšení
zdivo	zdiv
pojídání	pojídání
knedlík	knedlík
hostinský	hostinský
urychlení	urychlení
návyk	návyk
macek	macek
průliv	průliv
náruč	náruč
přetahování	přetahování
skandál	skandál
bcci	bcci
cennost	cennost
sejf	sejf
pistole	pistol
prst	prst
doplnění	doplnění
respekt	respekt
přihrávka	přihrávk
tvořivost	tvořivost
předvídavost	předvídavost
křoví	křoví
neshoda	neshod
kontroverze	kontroverz
oddíl	oddíl
čermák	čermák
pumpa	pump
nadšenec	nadšenec
klopýtnutí	klopýtnutí
klokan	klokan
bláznovství	bláznovství
gumárenství	gumárenství
oplátka	oplátk
obdržení	obdržení
škamna	škamn
zeštíhlení	zeštíhlení
vycházení	vycházení
stop	stop
poločas	poločas
comeback	comeback
kanonýr	kanonýr
rub	rub
ideál	ideál
sociologie	sociologi
trable	trabl
idyla	idyl
babka	babk
starousedlík	starousedlík
publicistika	publicistik
narkoman	narkoman
majáles	majáles
sekta	sekt
jehovista	jehovist
yuppie	yuppi
leitmotiv	leitmotiv
večírek	večírek
konfrontace	konfrontac
maturant	maturant
dospělost	dospělost
dokumentarista	dokumentarist
kurátor	kurátor
popředí	popředí
levičáctví	levičáctví
přívlastek	přívlastek
hoc	hoc
řetězec	řetězec
konsens	konsens
posunutí	posunutí
rekvalifikace	rekvalifikac
smír	smír
záplata	záplat
sjezd	sjezd
připlácení	připlácení
zubař	zubař
výchylka	výchylk
inženýrství	inženýrství
děkan	děkan
strojař	strojař
stavař	stavař
chemik	chemik
elektrotechnik	elektrotechnik
paralela	paralel
číšník	číšník
výčepní	výčepní
akceschopnost	akceschopnost
tuzemsko	tuzemsk
lira	lir
itl	itl
ocelárna	ocelárn
bilión	bilión
koncern	koncern
přecenění	přecenění
uvolnění	uvolnění
exsparťan	exsparťan
steh	steh
vzpírání	vzpírání
sportovec	sportovec
pauza	pauz
odkaz	odkaz
dramatik	dramatik
inscenátor	inscenátor
scénograf	scénograf
výrazivo	výraziv
aktualizace	aktualizac
směsice	směsic
zákoutí	zákoutí
prostranství	prostranství
reminiscence	reminiscenc
kulisa	kulis
seskupení	seskupení
exprese	expres
úklad	úklad
lhostejnost	lhostejnost
pokrytectví	pokrytectví
přihlížení	přihlížení
podkres	podkres
chlebíček	chlebíček
vzplanutí	vzplanutí
emotivita	emotivit
karikatura	karikatur
uškrcení	uškrcení
silueta	siluet
lůžkovina	lůžkovin
peří	peří
řev	řev
intrika	intrik
šátek	šátek
strážkyně	strážkyně
rouhač	rouhač
vášeň	vášeň
cit	cit
slast	slast
bidýlko	bidýlk
malba	malb
hravost	hravost
asambláž	asambláž
synonymum	synonymum
veselí	veselí
čtverec	čtverec
potěšení	potěšení
vzpomínání	vzpomínání
nadhled	nadhled
pousmání	pousmání
větvička	větvičk
vozíček	vozíček
kreace	kreac
promýšlení	promýšlení
vchod	vchod
souhláska	souhlásk
mafián	mafián
nepřítel	nepřítel
přelíčení	přelíčení
boss	boss
mříž	mříž
bycha	bych
revolucionář	revolucionář
nářek	nářek
předání	předání
odlišnost	odlišnost
prohřešek	prohřešek
evidence	evidenc
peripetie	peripeti
kostnice	kostnic
biskup	biskup
velikonoce	velikonoc
kovář	kovář
sklář	sklář
pohraničí	pohraničí
skalník	skalník
teritorium	teritorium
vyžití	vyžití
městečko	městečk
zástavba	zástavb
pokrytí	pokrytí
vypořádání	vypořádání
tisícikoruna	tisícikorun
falšování	falšování
výskyt	výskyt
bankovka	bankovk
pokladník	pokladník
falzifikát	falzifikát
zkvalitňování	zkvalitňování
vodoznak	vodoznak
proužek	proužek
obrazec	obrazec
padělek	padělek
příjemce	příjemc
odvod	odvod
ověření	ověření
útrata	útrat
touha	touh
lavička	lavičk
béčko	béčk
dlouhán	dlouhán
kopačka	kopačk
výstroj	výstroj
vápeník	vápeník
dohad	dohad
semifinále	semifinál
zpoždění	zpoždění
nařízení	nařízení
statut	statut
debut	debut
tygr	tygr
udílení	udílení
expres	expres
ruměnec	ruměnec
pointa	point
metafora	metafor
osamělost	osamělost
videoklip	videoklip
rozostření	rozostření
zpomalení	zpomalení
smoke	smok
padnutí	padnutí
blue	blu
face	fac
polibek	polibek
kiss	kiss
fiction	fiction
vrah	vrah
priest	priest
třetice	třetic
bone	bon
kingdom	kingdom
dvouapůlhodinový	dvouapůlhodinový
imaginace	imaginac
pláč	pláč
šachta	šacht
pacientka	pacientk
horor	horor
detektivka	detektivk
obraznost	obraznost
mystérium	mystérium
prostupování	prostupování
ovlivňování	ovlivňování
žánr	žánr
subkultura	subkultur
lesbička	lesbičk
artistka	artistk
hrátky	hrátk
renesance	renesanc
ústup	ústup
prožitek	prožitek
antihrdina	antihrdin
odcizení	odcizení
nuda	nud
malíř	malíř
nepřátelství	nepřátelství
zátaras	zátaras
znovuotevření	znovuotevření
překonání	překonání
zřizovatel	zřizovatel
tarif	tarif
přerozdělování	přerozdělování
kapitola	kapitol
hrazení	hrazení
propojenost	propojenost
horník	horník
vila	vil
sbírka	sbírk
upír	upír
ekvivalent	ekvivalent
senzačnost	senzačnost
věcnost	věcnost
defraudace	defraudac
tajnoslužebnictví	tajnoslužebnictví
pragmatičnost	pragmatičnost
nacionalita	nacionalit
učiliště	učiliště
paměť	paměť
karolínum	karolínum
předznamenání	předznamenání
marxismus	marxismus
leninismus	leninismus
vysokost	vysokost
odpovídání	odpovídání
tázání	tázání
zdatnost	zdatnost
akreditace	akreditac
bádání	bádání
zdar	zdar
exteritorium	exteritorium
reflexe	reflex
aula	aul
vládnutí	vládnutí
členění	členění
bodování	bodování
kolize	koliz
bon	bon
tuzex	tuzex
hlouček	hlouček
vekslák	vekslák
přízvuk	přízvuk
fórek	fórek
asignace	asignac
farář	farář
pranýř	pranýř
zástup	zástup
odpočet	odpočet
dík	dík
mrzout	mrzout
odpustek	odpustek
lord	lord
ochrnutí	ochrnutí
osnova	osnov
vada	vad
sluch	sluch
gong	gong
diagnóza	diagnóz
určování	určování
postižení	postižení
zařazování	zařazování
domněnka	domněnk
porucha	poruch
oralista	oralist
znakař	znakař
oralismus	oralismus
znakování	znakování
narození	narození
dánština	dánštin
rozvrh	rozvrh
zvládnutí	zvládnutí
pedagogika	pedagogik
gramatika	gramatik
komplikace	komplikac
kočka	kočk
výzdoba	výzdob
primárky	primárk
předpověď	předpověď
zvolení	zvolení
bonmot	bonmot
ovace	ovac
guvernérka	guvernérk
taškařice	taškařic
vyzyvatel	vyzyvatel
špína	špín
nezkušenost	nezkušenost
předprimárky	předprimárk
rozkol	rozkol
vicepremiérka	vicepremiérk
brigita	brigit
místopředsedkyně	místopředsedkyně
exvicepremiérka	exvicepremiérk
nezaměstnaný	nezaměstnaný
představitelka	představitelk
plynárenství	plynárenství
plynovod	plynovod
doručovatelka	doručovatelk
obhájce	obhájc
pach	pach
loupež	loupež
psovod	psovod
symbióza	symbióz
identifikace	identifikac
svědkyně	svědkyně
znaménko	znaménk
bunda	bund
absentér	absentér
bojkot	bojkot
zastrašování	zastrašování
družstevník	družstevník
velkodružstvo	velkodružstv
dodání	dodání
sucho	such
mráz	mráz
statistik	statistik
přeměna	přeměn
zjišťování	zjišťování
nahrazení	nahrazení
informatika	informatik
účetnictví	účetnictví
software	softwar
prohloubení	prohloubení
revue	revu
loutka	loutk
loutkář	loutkář
novorozenec	novorozenec
rebel	rebel
matrika	matrik
komediant	komediant
loutkářství	loutkářství
inspirace	inspirac
rovina	rovin
zákonitost	zákonitost
obtížnost	obtížnost
představení	představení
obrození	obrození
inteligence	inteligenc
vyspělost	vyspělost
přitažlivost	přitažlivost
pláteník	pláteník
kramář	kramář
kramářství	kramářství
cestář	cestář
hodinář	hodinář
měšťan	měšťan
buditel	buditel
výjimečnost	výjimečnost
sepsání	sepsání
smyšlenka	smyšlenk
historiografie	historiografi
publikum	publikum
naivita	naivit
osvícenství	osvícenství
pojetí	pojetí
divadelnictví	divadelnictví
obecenstvo	obecenstv
arnoštka	arnoštk
loutkoherec	loutkoherec
drak	drak
esejista	esejist
iluminace	iluminac
sebevzdělávání	sebevzdělávání
obecnost	obecnost
milost	milost
óda	ód
kantáta	kantát
žalm	žalm
pokání	pokání
zvěstování	zvěstování
střevíček	střevíček
slon	slon
safari	safari
rozbřesk	rozbřesk
křesílko	křesílk
veranda	verand
šálek	šálek
tma	tm
kvákání	kvákání
žába	žáb
cvrkot	cvrkot
cikáda	cikád
lžička	lžičk
spoušť	spoušť
kopeček	kopeček
jezírko	jezírk
zebra	zebr
žirafa	žiraf
opevnění	opevnění
slůně	slůně
pábitel	pábitel
přístav	přístav
otrok	otrok
opice	opic
plachtoví	plachtoví
nosič	nosič
vyzvání	vyzvání
žebračka	žebračk
závrať	závrať
průvodkyně	průvodkyně
moskyt	moskyt
obleček	obleček
viněta	vinět
mrefu	mrefu
ptáček	ptáček
vrčení	vrčení
větrák	větrák
mozek	mozek
kolonizátor	kolonizátor
kemp	kemp
buš	buš
lev	lev
ind	ind
výpravčí	výpravčí
uniforma	uniform
mužíček	mužíček
motyčka	motyčk
zahrádka	zahrádk
mangovník	mangovník
chininovník	chininovník
papaya	papay
eukalypt	eukalypt
mangrovník	mangrovník
nůž	nůž
semafor	semafor
baobab	baobab
memsahib	memsahib
how	how
rampa	ramp
fešák	fešák
koule	koul
ostrůvek	ostrůvek
luck	luck
termitiště	termitiště
pustina	pustin
pasák	pasák
sukně	sukně
chatrč	chatrč
plech	plech
agáve	agáv
květ	květ
drát	drát
tričko	tričk
byznysmen	byznysmen
nakupenda	nakupend
slovíčko	slovíčk
notýsek	notýsek
highway	highwa
želva	želv
barák	barák
bata	bat
spojnice	spojnic
asfalt	asfalt
díra	dír
past	past
mamut	mamut
volant	volant
náklaďák	náklaďák
potácení	potácení
pangejt	pangejt
vrak	vrak
ženich	ženich
nevěsta	nevěst
spropitné	spropitné
kufr	kufr
křesťan	křesťan
manažerka	manažerk
konkubína	konkubín
příjmení	příjmení
vzkaz	vzkaz
bezpečno	bezpečn
policajt	policajt
madame	madam
atrium	atrium
platan	platan
tree	tre
whisky	whisk
pahorek	pahorek
plůtek	plůtek
cestovatel	cestovatel
obálka	obálk
professor	professor
vůl	vůl
klobouček	klobouček
pláž	pláž
guide	guid
bus	bus
lodge	lodg
zenit	zenit
marabu	marabu
účetní	účetní
nosorožec	nosorožec
five	fiv
pětka	pětk
pýcha	pých
bába	báb
déšť	déšť
půlka	půlk
napajedlo	napajedl
bahno	bahn
lov	lov
pytlák	pytlák
ochránce	ochránc
zvěř	zvěř
trofej	trofej
pakůň	pakůň
vlnění	vlnění
marihuana	marihuan
banda	band
video	vide
hoch	hoch
salámovník	salámovník
busík	busík
úsměv	úsměv
eskortování	eskortování
brouk	brouk
vruboun	vruboun
moskytiéra	moskytiér
ložnice	ložnic
chlapík	chlapík
pravěk	pravěk
krabička	krabičk
výmol	výmol
samotář	samotář
pelikán	pelikán
prasátko	prasátk
antilopa	antilop
dál	dál
nebe	neb
vír	vír
vzduch	vzduch
palma	palm
náves	náves
waterproof	waterproof
lejno	lejn
košile	košil
kravata	kravat
dabljú	dabljú
window	window
ledvinka	ledvink
obřízka	obřízk
pevnost	pevnost
sultán	sultán
steak	steak
krokodýl	krokodýl
reproduktor	reproduktor
lázeň	lázeň
kolonizace	kolonizac
zoufalství	zoufalství
přírůstek	přírůstek
artikl	artikl
záclona	záclon
redaktorka	redaktork
listí	listí
psaníčko	psaníčk
zouvák	zouvák
chmýří	chmýří
náhoda	náhod
školák	školák
pruzení	pruzení
slatina	slatin
stud	stud
vzpěrač	vzpěrač
špendlík	špendlík
podobizna	podobizn
tvar	tvar
kapr	kapr
zvyk	zvyk
dobrodušnost	dobrodušnost
dětství	dětství
děda	děd
plovák	plovák
jasno	jasn
starostlivost	starostlivost
dírka	dírk
umyvadlo	umyvadl
gejzírek	gejzírek
přirovnání	přirovnání
hřebík	hřebík
sebepoznání	sebepoznání
koláž	koláž
zmatenost	zmatenost
kaplička	kapličk
kontura	kontur
evropanství	evropanství
pojem	pojem
liberalismus	liberalismus
libovolnost	libovolnost
bezzásadovost	bezzásadovost
redukce	redukc
maďarství	maďarství
lenost	lenost
věrnost	věrnost
ponížení	ponížení
sebeúcta	sebeúct
důstojnost	důstojnost
konsensus	konsensus
vzrušení	vzrušení
rutina	rutin
sparťan	sparťan
záložník	záložník
sestup	sestup
aspirant	aspirant
dorost	dorost
hattrick	hattrick
osmička	osmičk
dějství	dějství
vteřina	vteřin
marha	marh
exhibice	exhibic
kbelík	kbelík
bysta	byst
hřbitov	hřbitov
vyšetření	vyšetření
léčebna	léčebn
mauzoleum	mauzoleum
svatostánek	svatostánek
potentát	potentát
dění	dění
přistoupení	přistoupení
hybern	hybern
penalizace	penalizac
odborář	odborář
kovoprůmysl	kovoprůmysl
elektrotechnika	elektrotechnik
těžiště	těžiště
kovák	kovák
renomé	renomé
analytik	analytik
úspěšnost	úspěšnost
organizování	organizování
kolotoč	kolotoč
centrifuga	centrifug
zácpa	zácp
argentinec	argentinec
bundesliga	bundeslig
nevraživost	nevraživost
účinkování	účinkování
nebesa	nebes
ring	ring
tyátr	tyátr
juniorka	juniork
wimbledon	wimbledon
finalistka	finalistk
cirkus	cirkus
superhvězda	superhvězd
šatna	šatn
vyhnutí	vyhnutí
tenistka	tenistk
trenérka	trenérk
profesionálka	profesionálk
požitek	požitek
uzda	uzd
střídmost	střídmost
drobnost	drobnost
kopie	kopi
ace	ac
sparringpartner	sparringpartner
kapitánka	kapitánk
kříž	kříž
lyžařka	lyžařk
dívenka	dívenk
autogram	autogram
urozenost	urozenost
vévodkyně	vévodkyně
talířek	talířek
okrasa	okras
koulař	koulař
podstrojování	podstrojování
centrkurt	centrkurt
běžec	běžec
husa	hus
provázek	provázek
nonsens	nonsens
divadelník	divadelník
limerick	limerick
poezie	poezi
banket	banket
veselice	veselic
vylodění	vylodění
spojenec	spojenec
konzervativec	konzervativec
kuloár	kuloár
zásobník	zásobník
zárodek	zárodek
narušení	narušení
výbuch	výbuch
dekret	dekret
vyhazování	vyhazování
seč	seč
duma	dum
čtení	čtení
jen	jen
jpy	jp
přitvrzení	přitvrzení
unce	unc
opce	opc
letargie	letargi
transit	transit
expanze	expanz
učeň	učeň
rozpis	rozpis
čtyřnásobek	čtyřnásobek
rozběh	rozběh
tíseň	tíseň
školka	školk
šev	šev
rest	rest
vodné	vodné
hovor	hovor
stěhování	stěhování
vypracování	vypracování
ortel	ortel
projednávání	projednávání
zapomenutí	zapomenutí
přeháňka	přeháňk
oblačnost	oblačnost
náraz	náraz
bouřka	bouřk
krupobití	krupobití
napadení	napadení
ublížení	ublížení
spolumajitel	spolumajitel
jonák	jonák
rachot	rachot
šachista	šachist
letovisko	letovisk
rus	rus
jachta	jacht
souš	souš
dějiště	dějiště
vous	vous
šediny	šedin
tucet	tucet
hněv	hněv
šachistka	šachistk
génius	génius
klec	klec
regule	regul
jídelna	jídeln
patent	patent
milionář	milionář
nedělník	nedělník
pokračovatelka	pokračovatelk
nekrolog	nekrolog
přepych	přepych
vypsání	vypsání
dosazení	dosazení
chlad	chlad
teplárna	teplárn
teplo	tepl
náměstkyně	náměstkyně
nedoplatek	nedoplatek
lidožrout	lidožrout
hitparáda	hitparád
večerníček	večerníček
delfín	delfín
drezúra	drezúr
sýkorka	sýkork
mimikra	mimikr
caribe	carib
foukaliště	foukaliště
magazín	magazín
país	país
večerník	večerník
zpravodajství	zpravodajství
útěk	útěk
žurnál	žurnál
heute	heut
novost	novost
riviéra	riviér
zabiják	zabiják
šampión	šampión
stahování	stahování
mince	minc
řádění	řádění
výtržník	výtržník
bitka	bitk
výrostek	výrostek
pravice	pravic
vystupování	vystupování
radikalismus	radikalismus
urovnání	urovnání
maloodběratel	maloodběratel
vodárna	vodárn
odečet	odečet
vodoměr	vodoměr
profesionalizace	profesionalizac
kts	kts
odůvodnění	odůvodnění
agent	agent
důvěrník	důvěrník
běženec	běženec
chladnička	chladničk
pavilón	pavilón
hurikán	hurikán
outsider	outsider
mentalita	mentalit
známý	známý
fantazie	fantazi
konzumace	konzumac
denník	denník
vložení	vložení
nakládání	nakládání
istota	istot
dílec	dílec
přívod	přívod
motorest	motorest
staveniště	staveniště
správcování	správcování
správcovství	správcovství
reference	referenc
sousto	soust
výzbroj	výzbroj
hromadění	hromadění
potlačování	potlačování
aparát	aparát
cenzura	cenzur
vyhošťování	vyhošťování
vicepremiér	vicepremiér
magistrála	magistrál
útočiště	útočiště
živel	živel
azylant	azylant
pohotovost	pohotovost
součinnost	součinnost
garda	gard
kolt	kolt
puška	pušk
porážení	porážení
napodobenina	napodobenin
prach	prach
nádobíčko	nádobíčk
prodavač	prodavač
ranivost	ranivost
míček	míček
dostřel	dostřel
twr	twr
formule	formul
kamarádka	kamarádk
skandálnost	skandálnost
jeptiška	jeptišk
prezervativ	prezervativ
soumrak	soumrak
rokování	rokování
propast	propast
ouvertura	ouvertur
odezva	odezv
bonbónek	bonbónek
příchuť	příchuť
pluk	pluk
unikum	unikum
subjektivita	subjektivit
pomlčka	pomlčk
přímočarost	přímočarost
nařčení	nařčení
magnetofon	magnetofon
stenografka	stenografk
vysvětlování	vysvětlování
kolaps	kolaps
nekonečno	nekonečn
vyjasňování	vyjasňování
naplnění	naplnění
tužba	tužb
zviditelnění	zviditelnění
srozuměná	srozuměná
udička	udičk
rozmělňování	rozmělňování
metamorfóza	metamorfóz
dvojznačnost	dvojznačnost
obranyschopnost	obranyschopnost
sestavování	sestavování
farmacie	farmaci
distributor	distributor
normál	normál
kros	kros
zátěž	zátěž
půlmaratón	půlmaratón
dopoledne	dopoledn
kolík	kolík
protihráč	protihráč
obočí	obočí
vodovod	vodovod
pověření	pověření
náležitost	náležitost
konstituce	konstituc
ratifikace	ratifikac
spolužití	spolužití
celnice	celnic
bundeswehr	bundeswehr
předvečer	předvečer
maastricht	maastricht
generalita	generalit
volání	volání
demokratičnost	demokratičnost
racionálnost	racionálnost
svrchovanost	svrchovanost
světadíl	světadíl
lekce	lekc
úzkost	úzkost
řemeslník	řemeslník
idylka	idylk
subvence	subvenc
turbulence	turbulenc
vyčlenění	vyčlenění
bojeschopnost	bojeschopnost
odsunutí	odsunutí
modifikace	modifikac
předlužení	předlužení
smrtonosnost	smrtonosnost
úskalí	úskalí
zacházení	zacházení
oddlužení	oddlužení
chodba	chodb
úpadce	úpadc
zmrazení	zmrazení
zpeněžení	zpeněžení
rozběhnutí	rozběhnutí
mezičas	mezičas
rozchod	rozchod
serióznost	serióznost
kalibr	kalibr
intermezzo	intermezz
nitro	nitr
rozvědka	rozvědk
ústupnost	ústupnost
spiknutí	spiknutí
harmonogram	harmonogram
rozuzlení	rozuzlení
razantnost	razantnost
realista	realist
porce	porc
realizmus	realizmus
tempera	temper
formalista	formalist
výpovědní	výpovědní
portrait	portrait
artist	artist
man	man
chlapeček	chlapeček
triptych	triptych
figura	figur
vodka	vodk
ftalát	ftalát
stoličnaja	stoličnaj
meziprodukt	meziprodukt
zvláčňování	zvláčňování
hygienik	hygienik
miligram	miligram
l`litr	l`litr
barel	barel
skladování	skladování
etiketa	etiket
detekce	detekc
chlór	chlór
líh	líh
uzávěr	uzávěr
překupník	překupník
taktizování	taktizování
chovanec	chovanec
libero	liber
osa	os
nesrovnalost	nesrovnalost
zaúčtování	zaúčtování
kapavka	kapavk
mikrobiolog	mikrobiolog
syfilida	syfilid
videosnímek	videosnímek
grandhotel	grandhotel
porota	porot
šot	šot
pohraničník	pohraničník
uspokojení	uspokojení
ponaučení	ponaučení
palubovka	palubovk
zpracovávání	zpracovávání
sponzorství	sponzorství
odbíjenkářka	odbíjenkářk
svolání	svolání
uzenina	uzenin
terapie	terapi
sanatorium	sanatorium
podplukovník	podplukovník
vysílačka	vysílačk
přestřelka	přestřelk
výmysl	výmysl
souběh	souběh
konopí	konopí
políčko	políčk
sklizeň	sklizeň
cizina	cizin
helikoptéra	helikoptér
rodiště	rodiště
intervence	intervenc
trápení	trápení
desetiminutovka	desetiminutovk
čtyřbranková	čtyřbranková
hrot	hrot
val	val
průnik	průnik
prs	prs
klička	kličk
narážečka	narážečk
nevíra	nevír
ostrovan	ostrovan
trefa	tref
křest	křest
brusle	brusl
přilba	přilb
kalhoty	kalhot
stulpna	stulpn
kozel	kozel
čtyřiadvacítka	čtyřiadvacítk
vlček	vlček
působiště	působiště
fyzička	fyzičk
dvoustovka	dvoustovk
grog	grog
bufet	bufet
mantinel	mantinel
nerv	nerv
časomíra	časomír
střídačka	střídačk
rozehrání	rozehrání
vyslovení	vyslovení
spalovna	spalovn
třídění	třídění
recyklace	recyklac
korekce	korekc
demokratizace	demokratizac
korektura	korektur
delegát	delegát
vykázání	vykázání
sir	sir
spoluautor	spoluautor
roveň	roveň
odejmutí	odejmutí
doložka	doložk
stadium	stadium
snadnost	snadnost
federál	federál
proplacení	proplacení
lokomotiva	lokomotiv
rozhorlení	rozhorlení
data	dat
blamáž	blamáž
sirka	sirk
plýtvání	plýtvání
průmyslník	průmyslník
závaží	závaží
neklid	neklid
zápal	zápal
galeristka	galeristk
jednorožec	jednorožec
harfa	harf
galérie	galéri
amatér	amatér
duha	duh
vydražitel	vydražitel
tahanice	tahanic
doběh	doběh
usk	usk
pivot	pivot
pivotman	pivotman
rozehrávač	rozehrávač
duo	du
finalista	finalist
disciplinárka	disciplinárk
tahák	tahák
schůze	schůz
syndikát	syndikát
autorizace	autorizac
hašení	hašení
rašelina	rašelin
ložisko	ložisk
pískovec	pískovec
kombinát	kombinát
pyrotechnik	pyrotechnik
imago	imag
satelit	satelit
superset	superset
oáza	oáz
putování	putování
páter	páter
nenávist	nenávist
vesmír	vesmír
patrola	patrol
männermagazin	männermagazin
manévr	manévr
stožár	stožár
zmatek	zmatek
arcibiskup	arcibiskup
primas	primas
mentorování	mentorování
freon	freon
ozón	ozón
sprej	sprej
halon	halon
štěrkovna	štěrkovn
pískovna	pískovn
spoření	spoření
ukládání	ukládání
emitent	emitent
vyplacení	vyplacení
pyramida	pyramid
šestice	šestic
věž	věž
stážista	stážist
zmatení	zmatení
končetina	končetin
kyj	kyj
kamikadze	kamikadz
exposlanec	exposlanec
liberál	liberál
erudice	erudic
souputník	souputník
legitimace	legitimac
přerod	přerod
pozastavení	pozastavení
vytyčování	vytyčování
vysočina	vysočin
závodník	závodník
hlupák	hlupák
plavkyně	plavkyně
rozhořčení	rozhořčení
svěřenkyně	svěřenkyně
kapesné	kapesné
vypočítavost	vypočítavost
zákulisí	zákulisí
legie	legi
lustrace	lustrac
magika	magik
stání	stání
dentista	dentist
aids	aids
chrup	chrup
hiv	hiv
čtenářka	čtenářk
běták	běták
beták	beták
bět	bět
bet	bet
betíi	betíi
přípona	přípon
odvozenina	odvozenin
řečtina	řečtin
hebrejština	hebrejštin
přísaha	přísah
normalizátor	normalizátor
opravdovost	opravdovost
umývač	umývač
nádobí	nádobí
uklízeč	uklízeč
firmička	firmičk
satisfakce	satisfakc
letošek	letošek
kněžna	kněžn
plamen	plamen
popelník	popelník
trochu	trochu
chirurgie	chirurgi
telegraf	telegraf
uskutečňování	uskutečňování
interakce	interakc
market	market
ctnost	ctnost
korektor	korektor
klérus	klérus
nerudnost	nerudnost
bohoslužba	bohoslužb
kapička	kapičk
odluka	odluk
polosvětlo	polosvětl
polostín	polostín
pay	pa
rozeklanost	rozeklanost
pól	pól
kašička	kašičk
načasování	načasování
zesílení	zesílení
bezradnost	bezradnost
plavky	plavk
deštník	deštník
kredit	kredit
extrém	extrém
samovývoj	samovývoj
pronikání	pronikání
tiskovina	tiskovin
strnulost	strnulost
nevůle	nevůl
protekcionismus	protekcionismus
rekreace	rekreac
splacení	splacení
protiprávnost	protiprávnost
klacek	klacek
dokazování	dokazování
koželužna	koželužn
květina	květin
pomníček	pomníček
diecéze	diecéz
bula	bul
navrhování	navrhování
obuv	obuv
modelování	modelování
stánkař	stánkař
vata	vat
gymnastka	gymnastk
atletka	atletk
trojskokanka	trojskokank
kladivo	kladiv
atlet	atlet
průkopník	průkopník
konkurentka	konkurentk
víceboj	víceboj
škrt	škrt
tyčkařka	tyčkařk
gymnastika	gymnastik
štír	štír
veleskok	veleskok
kapitalismus	kapitalismus
destabilizace	destabilizac
škodlivost	škodlivost
parazitismus	parazitismus
vyústění	vyústění
bauhaus	bauhaus
nářadí	nářadí
kutil	kutil
fotograf	fotograf
zvukař	zvukař
cobra	cobr
odzbrojení	odzbrojení
nálet	nálet
slintavka	slintavk
kulhavka	kulhavk
tajnost	tajnost
známost	známost
tvor	tvor
zrak	zrak
atavismus	atavismus
dorozumívání	dorozumívání
homo	hom
sloučenina	sloučenin
feromon	feromon
agresivita	agresivit
potrava	potrav
communication	communication
language	languag
pheromone	pheromon
řasa	řas
hmyz	hmyz
pták	pták
plaz	plaz
savec	savec
samec	samec
snake	snak
impersonating	impersonating
samička	samičk
pavouk	pavouk
spider	spider
sameček	sameček
harpuna	harpun
zoologie	zoologi
čich	čich
receptor	receptor
neurolog	neurolog
indispozice	indispozic
metrika	metrik
předivo	přediv
zástoj	zástoj
identita	identit
prolnutí	prolnutí
fragmentace	fragmentac
objektivita	objektivit
god	god
view	view
šifrování	šifrování
prvočíslo	prvočísl
jednoduchost	jednoduchost
abeceda	abeced
čárka	čárk
orel	orel
přičtení	přičtení
utajení	utajení
rozklad	rozklad
součin	součin
cifra	cifr
mocnina	mocnin
podepisování	podepisování
umocňování	umocňování
dešifrování	dešifrování
kódování	kódování
mars	mars
svítivost	svítivost
albedo	albed
zamrznutí	zamrznutí
oteplení	oteplení
veličina	veličin
oscilace	oscilac
mrak	mrak
přehřátí	přehřátí
hnojení	hnojení
železo	želez
schránka	schránk
fosfor	fosfor
uhlík	uhlík
přemnožení	přemnožení
eliminace	eliminac
spalování	spalování
proudění	proudění
míchání	míchání
mísení	mísení
plavidlo	plavidl
transekt	transekt
radiouhlík	radiouhlík
research	research
modeling	modeling
fosílie	fosíli
grypania	grypani
filament	filament
kyslík	kyslík
pásek	pásek
křemen	křemen
minerál	minerál
geolog	geolog
oxidace	oxidac
ferrum	ferrum
evoluce	evoluc
koexistence	koexistenc
křivka	křivk
šipka	šipk
fytoplankton	fytoplankton
odbourávání	odbourávání
dimetylsulfid	dimetylsulfid
pára	pár
nanometr	nanometr
ztenčení	ztenčení
antarktida	antarktid
měření	měření
poškození	poškození
tloušťka	tloušťk
tání	tání
ledovec	ledovec
plavba	plavb
normalizace	normalizac
tisícina	tisícin
obstarávání	obstarávání
mravenec	mravenec
cataglyphis	cataglyphis
ještěrka	ještěrk
acanthodactylus	acanthodactylus
dumerili	dumerili
nika	nik
monomorium	monomorium
prérie	préri
lasius	lasius
myrmica	myrmic
tetramorium	tetramorium
živočich	živočich
eremogarypus	eremogarypus
celsius	celsius
membrána	membrán
vajíčko	vajíčk
vystavení	vystavení
pozorování	pozorování
červ	červ
alvinella	alvinell
ochlazení	ochlazení
geofyzik	geofyzik
odpařování	odpařování
meteorit	meteorit
sodík	sodík
dublet	dublet
molekula	molekul
iont	iont
hydrát	hydrát
ochlazování	ochlazování
preparát	preparát
zředění	zředění
vydávání	vydávání
příručka	příručk
přírodovědec	přírodovědec
lesník	lesník
odevzdání	odevzdání
poster	poster
nouze	nouz
pružnost	pružnost
neefektivnost	neefektivnost
osamostatňování	osamostatňování
proznačení	proznačení
tiskárna	tiskárn
externista	externist
curriculum	curriculum
vitae	vita
vypravování	vypravování
báje	báj
geometrie	geometri
room	room
variety	variet
will	will
worth	worth
wanting	wanting
loket	loket
odhalování	odhalování
vymýtání	vymýtání
bubák	bubák
příměr	příměr
intuice	intuic
trik	trik
vyhnutelnost	vyhnutelnost
determinismus	determinismus
fatalismus	fatalismus
terminologie	terminologi
robot	robot
anténka	anténk
žárovička	žárovičk
sloveso	sloves
logaritmus	logaritmus
sinus	sinus
korespondence	korespondenc
neosoba	neosob
krematorium	krematorium
katafalk	katafalk
variabil	variabil
znemožnění	znemožnění
trám	trám
břevno	břevn
škrtnutí	škrtnutí
pero	per
překližka	překližk
plát	plát
plexisklo	plexiskl
pant	pant
šroub	šroub
nastavení	nastavení
variabilita	variabilit
spoutanost	spoutanost
sevřenost	sevřenost
závora	závor
slepec	slepec
mene	men
tekel	tekel
stín	stín
zmar	zmar
destrukce	destrukc
ničení	ničení
prázdnota	prázdnot
kyvadlo	kyvadl
lidskost	lidskost
úcta	úct
chvění	chvění
smutek	smutek
smích	smích
rakovina	rakovin
buňka	buňk
umírání	umírání
defekt	defekt
autoagrese	autoagres
bujení	bujení
nemocný	nemocný
vývěska	vývěsk
videozáznam	videozáznam
shlédnutí	shlédnutí
lymfocyt	lymfocyt
zabíječ	zabíječ
mikrob	mikrob
veselohra	veselohr
stimulans	stimulans
angína	angín
chřipka	chřipk
nachlazení	nachlazení
isoprinosin	isoprinosin
veselost	veselost
devítka	devítk
rozesílání	rozesílání
níže	níž
sahara	sahar
středověk	středověk
kronikář	kronikář
zčervenání	zčervenání
roura	rour
přehlušení	přehlušení
bouře	bouř
oteplování	oteplování
substrát	substrát
pokrývka	pokrývk
dust	dust
letter	letter
april	april
štít	štít
zalednění	zalednění
sediment	sediment
pleistocén	pleistocén
chronologie	chronologi
rezervoár	rezervoár
žíla	žíl
geochemik	geochemik
vrt	vrt
nuklid	nuklid
observatoř	observatoř
geochronologie	geochronologi
paleoklimatolog	paleoklimatolog
oslunění	oslunění
šířka	šířk
mikrofosilie	mikrofosili
kalcit	kalcit
korál	korál
podzemí	podzemí
usazení	usazení
plž	plž
urychlovač	urychlovač
zoolog	zoolog
mlž	mlž
mya	my
škeble	škebl
srdcovka	srdcovk
perlorodka	perlorodk
spektrometrie	spektrometri
arytmie	arytmi
fígl	fígl
judo	jud
karcinogen	karcinogen
hlodavec	hlodavec
karcinogenita	karcinogenit
houba	houb
reziduum	reziduum
požívání	požívání
mechanika	mechanik
trpaslík	trpaslík
krystal	krystal
astrofyzik	astrofyzik
slupka	slupk
hustota	hustot
částice	částic
kulička	kuličk
luminozita	luminozit
apoptóza	apoptóz
bcl	bcl
onkogen	onkogen
sebedestrukce	sebedestrukc
obratlovec	obratlovec
neuron	neuron
aktivace	aktivac
ced	ced
protein	protein
mitochondrie	mitochondri
opalování	opalování
slunění	slunění
zajatec	zajatec
solárium	solárium
psoriáza	psoriáz
virolog	virolog
biolog	biolog
recyklování	recyklování
peleta	pelet
uchovávání	uchovávání
hypertext	hypertext
hyperknihovna	hyperknihovn
architekt	architekt
mnohost	mnohost
autokracie	autokraci
smazání	smazání
oblige	oblig
dokonalost	dokonalost
space	spac
history	histor
writing	writing
trvalost	trvalost
programování	programování
vyvolání	vyvolání
arabština	arabštin
gama	gam
perština	perštin
omikron	omikron
turečtina	turečtin
astronomie	astronomi
obloha	obloh
poloostrov	poloostrov
přejímání	přejímání
nadir	nadir
azimut	azimut
učenec	učenec
označování	označování
technik	technik
kosmonautika	kosmonautik
družice	družic
sonda	sond
okysličování	okysličování
slučování	slučování
rezavění	rezavění
líc	líc
oxidans	oxidans
reduktans	reduktans
fotosyntéza	fotosyntéz
dárce	dárc
vodík	vodík
síran	síran
ns`nanosekunda	ns`nanosekund
proton	proton
laureát	laureát
elektroda	elektrod
vibrace	vibrac
přeskok	přeskok
rozkmit	rozkmit
přebudování	přebudování
biochemie	biochemi
rozhraní	rozhraní
kapalina	kapalin
ion	ion
můstek	můstek
stipendista	stipendist
čekárna	čekárn
vzorec	vzorec
prostoj	prostoj
fyzika	fyzik
ekosystém	ekosystém
obvod	obvod
vědění	vědění
synergetik	synergetik
všehochuť	všehochuť
prostota	prostot
pokračovatel	pokračovatel
makrosystém	makrosystém
konfigurace	konfigurac
mikrostav	mikrostav
makrostav	makrostav
přihrádka	přihrádk
nádoba	nádob
entropie	entropi
vzrůst	vzrůst
migrace	migrac
pozorovatelna	pozorovateln
asymetrie	asymetri
makrosvět	makrosvět
liška	lišk
mřížka	mřížk
množina	množin
rozdílnost	rozdílnost
rndr	rndr
csc	csc
radiometrie	radiometri
astrofyzika	astrofyzik
geografie	geografi
úmrtnost	úmrtnost
demografie	demografi
geodemografie	geodemografi
drsc	drsc
endokrinologie	endokrinologi
metabolizmus	metabolizmus
geologie	geologi
kenozoikum	kenozoikum
geochemie	geochemi
létavice	létavic
lunatik	lunatik
antropologie	antropologi
skupenství	skupenství
epidemie	epidemi
optimalizace	optimalizac
leknín	leknín
hlemýžď	hlemýžď
shluk	shluk
rámeček	rámeček
poloměr	poloměr
zobecnění	zobecnění
důlek	důlek
nepořádek	nepořádek
symbolika	symbolik
tuha	tuh
diamant	diamant
polymorfizmus	polymorfizmus
lambda	lambd
helium	helium
feromagnet	feromagnet
magnetka	magnetk
magnetizace	magnetizac
magnet	magnet
hrana	hran
ferromagnet	ferromagnet
perkolace	perkolac
prosakování	prosakování
kanálek	kanálek
vytěžení	vytěžení
pór	pór
hornina	hornin
protlačování	protlačování
pravidelnost	pravidelnost
opodstatnění	opodstatnění
návnada	návnad
bacilonosič	bacilonosič
charakteristika	charakteristik
karanténa	karantén
předpovídání	předpovídání
plazma	plazm
anténa	antén
letectví	letectví
planetka	planetk
asteroid	asteroid
odraz	odraz
úlomek	úlomek
gravitace	gravitac
telátko	telátk
býček	býček
potomstvo	potomstv
vnesení	vnesení
laktoferin	laktoferin
bílkovina	bílkovin
kvasinka	kvasink
chromozóm	chromozóm
anomálie	anomáli
biosféřan	biosféřan
meteor	meteor
biosféra	biosfér
úbytek	úbytek
hermetičnost	hermetičnost
osádka	osádk
velehora	velehor
výzkumník	výzkumník
týrání	týrání
přístřešek	přístřešek
opálenost	opálenost
vuřt	vuřt
sopka	sopk
záře	zář
aparatura	aparatur
vypuštění	vypuštění
cluster	cluster
magnetosféra	magnetosfér
puls	puls
korpuskule	korpuskul
kosmodrom	kosmodrom
kosmonaut	kosmonaut
rovník	rovník
jezero	jezer
křižovatka	křižovatk
valuta	valut
vver	vver
mw`megawatt	mw`megawatt
turbína	turbín
fyzik	fyzik
ověřování	ověřování
špion	špion
mlčení	mlčení
puma	pum
štěpení	štěpení
neutron	neutron
grafit	grafit
nacista	nacist
vyslanectví	vyslanectví
rezident	rezident
špión	špión
informátor	informátor
dezinformace	dezinformac
ulička	uličk
zatčení	zatčení
přítok	přítok
užitek	užitek
špionáž	špionáž
zaostalost	zaostalost
konstruování	konstruování
spuštění	spuštění
ručička	ručičk
galvanometr	galvanometr
archeolog	archeolog
reálnost	reálnost
údobí	údobí
výkop	výkop
archeologie	archeologi
svolení	svolení
pozůstatek	pozůstatek
kostra	kostr
interiér	interiér
oltář	oltář
prozkoumání	prozkoumání
světec	světec
útlak	útlak
naivnost	naivnost
evangelík	evangelík
ostatek	ostatek
uctívání	uctívání
protireformace	protireformac
svatořečení	svatořečení
pekař	pekař
císař	císař
klér	klér
vikář	vikář
trhlina	trhlin
rift	rift
kráter	kráter
močál	močál
doplněk	doplněk
pahorkatina	pahorkatin
kužel	kužel
ústí	ústí
sopouch	sopouch
vulkán	vulkán
dutina	dutin
žár	žár
trans	trans
smírnost	smírnost
půdorys	půdorys
puklina	puklin
trubice	trubic
stalaktit	stalaktit
odkapávání	odkapávání
láva	láv
jeskyně	jeskyně
bazalt	bazalt
souvrství	souvrství
odnos	odnos
výlitek	výlitek
plášť	plášť
suť	suť
zvětralina	zvětralin
august	august
monstrance	monstranc
relikvie	relikvi
lebka	lebk
skelet	skelet
infrakce	infrakc
čelist	čelist
výslech	výslech
výběžek	výběžek
lopatka	lopatk
štosování	štosování
očnice	očnic
kost	kost
spodina	spodin
hniloba	hnilob
exhumace	exhumac
fort	fort
jařmo	jařm
kopanec	kopanec
nalomení	nalomení
kloub	kloub
vykloubení	vykloubení
pouzdro	pouzdr
vyjmutí	vyjmutí
pruh	pruh
plasticita	plasticit
zemina	zemin
povlak	povlak
lom	lom
lamela	lamel
nečistota	nečistot
omytí	omytí
kvadrant	kvadrant
drť	drť
ohledání	ohledání
lupa	lup
mikroskop	mikroskop
vlákénko	vlákénk
hrudka	hrudk
mozkovna	mozkovn
vysychání	vysychání
jáma	jám
naklonění	naklonění
otvor	otvor
zvlhnutí	zvlhnutí
zbobtnání	zbobtnání
spánek	spánek
travina	travin
rosa	ros
četnost	četnost
projektil	projektil
zeměkoule	zeměkoul
vulkanismus	vulkanismus
diagram	diagram
nálož	nálož
radiace	radiac
úmrtí	úmrtí
smolinec	smolinec
rádium	rádium
interval	interval
filamentum	filamentum
granulum	granulum
svině	svině
vlk	vlk
karbonát	karbonát
vrstvička	vrstvičk
roztopení	roztopení
úses	úses
abc	abc
přímka	přímk
úsečka	úsečk
rozlomení	rozlomení
polopřímka	polopřímk
souběžka	souběžk
souběžnost	souběžnost
spp	spp
pata	pat
kolmice	kolmic
polorovina	polorovin
aqb	aqb
součet	součet
aps	aps
sqb	sqb
spa	sp
qsb	qsb
psa	ps
přepona	přepon
odvěsna	odvěsn
acd	acd
adc	adc
acb	acb
pojednání	pojednání
pqrp	pqrp
čtyřúhelník	čtyřúhelník
souměrnost	souměrnost
shodnost	shodnost
mpp	mpp
page	pag
mpq	mpq
ppm	ppm
průsečík	průsečík
rozběžka	rozběžk
ps`pikosekunda	ps`pikosekund
pqqp	pqqp
nrp	nrp
sqq	sqq
hpq	hpq
mqs	mqs
qbbq	qbbq
aba	ab
pxx	pxx
yxx	yxx
xyyx	xyyx
xyyz	xyyz
yzx	yzx
přehlednost	přehlednost
app	app
bbd	bbd
apb	apb
matematik	matematik
vidina	vidin
sebezapření	sebezapření
osvětlování	osvětlování
poznávání	poznávání
geometr	geometr
záludnost	záludnost
příbuznost	příbuznost
paprsek	paprsek
nadhlavník	nadhlavník
dlaň	dlaň
stálice	stálic
odstup	odstup
přibližování	přibližování
odkrytí	odkrytí
zmenšování	zmenšování
popření	popření
umísťování	umísťování
zdokonalování	zdokonalování
změření	změření
přírodověda	přírodověd
ztotožnění	ztotožnění
zavržení	zavržení
srovnalost	srovnalost
